able_to_handle	hala_karane_meM_sakRama#hala_karane_meM_sakRama#verb#3#WM
able_to_walk	cala_pA#cala_pA#verb#3#RM
is_said_to_be	kaha_jAwA_hE#kaha_jAwA_hE#verb#2#RM
let_there_be	ho#ho#verb#3#RM
note_that	XyAna_xIjie_ki#XyAna_xIjie_ki#verb#1#WM
taking_courage_in_both_hands	jI_kadZA_karake_badZI_himmawa_se#jI_kadZA_karake_badZI_himmawa_se#verb#1#RM
gaining_hold	prApwa_kara#prApwa_kara#verb#1#RM
agreed_to_in_principle	sixXAnwa_rUpa_se_rAjI/sixXAMwawaH_svIkqwa#sixXAnwa_rUpa_se_rAjI/sixXAMwawaH_svIkqwa#verb#4#RM
back_up	samarWana/prawi_banAnA_kampyUtara#samarWana/prawi_banAnA_kampyUtara#verb#2#RM
beat_out	kisI_ko_harAnA/rikArda_wodZanA/kIrwimAna_sWApiwa_karanA#kisI_ko_harAnA/rikArda_wodZanA/kIrwimAna_sWApiwa_karanA#verb#2#RM
cast_down	hawowsAhiwa_karanA#hawowsAhiwa_karanA#verb#2#RM
close_down	baMxa_kara_xenA/pAsa/banxa_karanA#baMxa_kara_xenA/pAsa/banxa_karanA#verb#2#RM
close_down's	pAsa/banxa_karanA#pAsa/banxa_karanA#verb#2#RM
drew_up	KAkA_wEyAra_karanA/ciwriwa_kiyA#KAkA_wEyAra_karanA/ciwriwa_kiyA#verb#2#RM
fall_back	punaH_pawana_honA/pawana/giranA#punaH_pawana_honA/pawana/giranA#verb#2#RM
guaranteeing_fully_and_unconditionally	pUrNawaH_Ora_binA_Sarwa_gAraMtI_xenA#pUrNawaH_Ora_binA_Sarwa_gAraMtI_xenA#verb#4#RM
re_examine	punaH_pUCa_wACa_karanA/punaH_parIkRA_karanA#punaH_pUCa_wACa_karanA/punaH_parIkRA_karanA#verb#2#RM
re_survey	punaH_nirIkRaNa_karanA/punaH_sarvekRaNa_karanA#punaH_nirIkRaNa_karanA/punaH_sarvekRaNa_karanA#verb#2#RM
restoring_sick_units	rugNa_ikAiyoM_ko_punaHsakRama_banAnA#rugNa_ikAiyoM_ko_punaHsakRama_banAnA#verb#3#RM
would_love_to	KuSI_se_karanA/icCA se karanA#KuSI_se_karanA/icCA se karanA#verb#3#RM
blow_off	udZAnA/PUzkanA/udZanA/XakkA/GUzsA/PUzkanA#udZAnA/PUzkanA/udZanA/XakkA/GUzsA/PUzkanA#verb#1#RM
bog_down	ulaJanA/xalaxala_meM_XaMsanA/xabanA#ulaJanA/xalaxala_meM_XaMsanA/xabanA#verb#1#RM
cast_down	uxAsa_honA/hawowsAhiwa_karawA_hE#uxAsa_honA/hawowsAhiwa_karawA_hE#verb#1#RM
climb_down	apanI_galawI_mAnanA/uwara_AnA/nIce#apanI_galawI_mAnanA/uwara_AnA/nIce#verb#1#RM
co_operate	sahayoga_karanA/sahakArya_karanA#sahayoga_karanA/sahakArya_karanA#verb#2#RM
co_operates	sahayoga_karawA_hE/sahakArya_karanA#sahayoga_karawA_hE/sahakArya_karanA#verb#2#RM
cook_up	banAnA/pakAnA#banAnA/pakAnA#verb#1#RM
cut_in	bIca_meM_tokanA/kAtanA#bIca_meM_tokanA/kAtanA#verb#1#RM
drag_hunt	kAztA_dAlakara_walASanA/GasItanA#kAztA_dAlakara_walASanA/GasItanA#verb#2#RM
follow_through	aMwa_waka_pUrA_karanA/anusaraNa_kara/samaJanA#aMwa_waka_pUrA_karanA/anusaraNa_kara/samaJanA#verb#1#RM
wall_up	xIvAra_se_banxa_karanA/cunanA#xIvAra_se_banxa_karanA/cunanA#verb#1#RM
call_by_on	howe_huE_jA#howe_huE_jA#verb#1#RM
read_well	pATaka_kI_ruci_banAe_raKa#pATaka_kI_ruci_banAe_raKa#verb#1#RM
reads_well	pATaka_kI_ruci_banAe_raKa#pATaka_kI_ruci_banAe_raKa#verb#1#RM
casting_lots	sAJA_karanA#sAJA_karanA#verb#1#RM
close_down	banxa_karanA#banxa_karanA#verb#1#RM
close_down's	banxa_karanA#banxa_karanA#verb#1#RM
fall_back	punaH_pawana_honA/mExAna_CodZanA/pICe_hatanA#punaH_pawana_honA/mExAna_CodZanA/pICe_hatanA#verb#1#RM
fall_back's	punaH_pawana_honA/mExAna_CodZanA/pICe_hatanA#punaH_pawana_honA/mExAna_CodZanA/pICe_hatanA#verb#1#RM
hang_out	TaharanA#TaharanA#verb#1#RM
involving_question_of_policy	jisameM_vyavahAra_karane_kI_prawikriyA_SAmila_ho#jisameM_vyavahAra_karane_kI_prawikriyA_SAmila_ho#verb#1#RM
jump_off	saPalawA_se_Age_baDZanA/awirikwa_xOdZa#saPalawA_se_Age_baDZanA/awirikwa_xOdZa#verb#1#RM
kick_up	upaxrava_KadZA_karanA#upaxrava_KadZA_karanA#verb#1#RM
kiss_off	cUmanA#cUmanA#verb#1#RM
kiss_off's	cUmanA#cUmanA#verb#1#WM
make_believe	Cala_karanA#Cala_karanA#verb#1#RM
make_believe's	Cala_karanA#Cala_karanA#verb#1#WM
name_dropping	badZe_evaM_prasixXa_logoM_kA_nAma_lenA#badZe_evaM_prasixXa_logoM_kA_nAma_lenA#verb#2#RM
opt_for	vikalpa_cunanA#vikalpa_cunanA#verb#1#RM
pick_ups	uTAnA#uTAnA#verb#1#RM
play_off's	logoM_ko_Apasa_meM_BidZA_xenA#logoM_ko_Apasa_meM_BidZA_xenA#verb#1#RM
roll_on	jalxI_AnA#jalxI_AnA#verb#1#RM
slip_up	galawI_karanA#galawI_karanA#verb#1#RM
slip_up's	galawI_karanA#galawI_karanA#verb#1#RM
slip_up's	galawI_karanA/PisalanA#galawI_karanA/PisalanA#verb#1#WM
speed_up's	gawi_pakadZanA#gawi_pakadZanA#verb#1#WM
sponge_down	spaMja_se_sAPa_karanA#spaMja_se_sAPa_karanA#verb#1#RM
sponge_down's	spaMja_se_sAPa_karanA#spaMja_se_sAPa_karanA#verb#1#WM
strictly_speaking	kadZAI_se_bolanA#kadZAI_se_bolanA#verb#2#RM
take_in	Gara_meM_Ane_xenA/JAzse_meM_AnA/lenA#Gara_meM_Ane_xenA/JAzse_meM_AnA/lenA#verb#1#RM
take_in's	Gara_meM_Ane_xenA/JAzse_meM_AnA/lenA#Gara_meM_Ane_xenA/JAzse_meM_AnA/lenA#verb#1#WM
throw_in	PeMkanA#PeMkanA#verb#1#RM
tie_in	sambaxXa_honA#sambaxXa_honA#verb#1#RM
tie_in's	sambaxXa_honA#sambaxXa_honA#verb#1#WM
tip_up	eka_kinAre_se_uTAnA#eka_kinAre_se_uTAnA#verb#2#RM
toss_up	xo_vikalpoM_ke_bIca_nirNaya_karane_kI_koSiSa_karanA#xo_vikalpoM_ke_bIca_nirNaya_karane_kI_koSiSa_karanA#verb#1#RM
toss_up's	xo_vikalpoM_ke_bIca_nirNaya_karane_kI_koSiSa_karanA#xo_vikalpoM_ke_bIca_nirNaya_karane_kI_koSiSa_karanA#verb#1#WM
weigh_in	wolanA#wolanA#verb#1#RM
weigh_in's	wolanA#wolanA#verb#1#WM
wind_up	samApwa_karanA/cAbI_xenA/lapetanA#samApwa_karanA/cAbI_xenA/lapetanA#verb#1#RM
work_in	milAnA/jodZanA#milAnA/jodZanA#verb#1#RM
work_in's	milAnA/jodZanA#milAnA/jodZanA#verb#1#WM
would_love_to	pasanxa_karanA#pasanxa_karanA#verb#2#RM
