#administrative dictionary extracted by Shubangi. Formatted by Roja (26-01-2016)	#administrative dictionary extracted by Shubangi. Formatted by Roja (26-01-2016)
#Changes:: 1) Separated single word and multi words into separate dictionaries	#Changes:: 1) Separated single word and multi words into separate dictionaries
#          2) English words are converted to lower case	#          2) English words are converted to lower case
#          3) Added category as 'noun' by default	#          3) Added category as 'noun' by default
#################################################################################	#################################################################################
abandonment_noun	pariwyAga
abate_noun	upaSamana_karanA/upaSamana_honA/kamI_karanA/kamI_honA
abatement_noun	upaSamana/kamI
abbreviation_noun	safkRipwi
abdicate_noun	paxa_wyAga_xenA
abduction_noun	apaharaNa/BagA_le_jAnA
abet_noun	xuRpreriwa_karanA
abettor_noun	xuRpreraka
abeyance_noun	prAsWagana
ability_noun	yogyawA
able_noun	yogya
abnormal_noun	apasAmAnya
abolition_noun	unmUlana
aboriginal_noun	AxivAsI
abridge_noun	kama_karanA_(jEse_Sakwi)/safkRipwa_karanA_(jEse_riporta)
abridgement_noun	safkRepaNa/kamI_(jEse_Sakwi)
abrogate_noun	nirAkaraNa
abrogation_noun	nirAkaraNa
absconder_noun	ParAra/ParArI
absence_noun	anupafsWfAwa/gErahAjLrI/aBAva
absentee_noun	anupasWiwa/gErahAjLra
absolve_noun	vimukwa_karanA
absorb_noun	Amelana/avaSoRaNa_karanA
absorption_noun	Amelana/avaSoRaNa
abstain_noun	pravirawa_rahanA
abstract_noun	sAra
abstractor_noun	sArakarwA
absurd_noun	arWahIna/bewukA
absurdity_noun	arWahInawA/bewukApana
abuse_noun	xurupayoga
academic_noun	akAxamika/SEkRaNika/vixyA_sambanXI/SAswrIya
academician_noun	vixyAvix
academics_noun	vixyAvix
academy_noun	akAxamI
accede_noun	mAna_lenA/aXimilana
acceleration_noun	wvaraNa
accept_noun	svIkAra_karanA/mAnanA
acceptability_noun	svIkAryawA
acceptable_noun	svIkArya
acceptance_noun	svIkqwi/prawigrahaNa_(viXi)
access_noun	pahuca
accession_noun	rAjyArohaNa/paxArohaNa/parigrahaNa/aXimilana
accessory_noun	anuRafgI/upasAXana
accident_noun	xuGatanA/saMyoga
accidental_noun	Akafsmaka
acclimatization_noun	paryanukUlana
accommodation_noun	AvAsa/nirvAha
accompanist_noun	safgawakAra
accomplished_noun	pravINa/susaMskqwa/sampAxiwa
accord_noun	samaJOwA/praxAna_karanA/xenA/mela_KAnA/anurUpa_honA
accordingly_noun	waxanusAra
account_noun	leKA/KAwA/hisAba
accountability_noun	javAbaxehI
accountable_noun	javAbaxeha/xenaxAra/leKA_xeya
accountal_noun	leKA-joKA
accountancy_noun	leKASAswra/leKAviXi/leKA_pAlana/leKAkArya
accountant_noun	leKAkAra
accoutrement_noun	sAja-sajjA
accredit_noun	prawyAyiwa_karanA
accreditation_noun	prawyAyana
accretion_noun	afBavqxXi
accrual_noun	proxBavana
accrue_noun	proxBUwa_honA
accrued_noun	proxBUwa
accumulation_noun	saFcaya/saFcayana
accuracy_noun	yaWArWawA/pariSuxXawA
accurate_noun	yaWArWa/sahI/TIka/pariSuxXa
accurately_noun	yaWArWawa:/yaWArWa_rUpa_se
accusation_noun	xoRAropaNa/afBayoga_(viXi)
accuse_noun	xoRAropaNa_karanA/afBayoga_lagAnA
accused_noun	afBayukwa
achievement_noun	upalabXi
acknowledge_noun	prApwi_svIkAra_karanA/pAvawI_xenA
acknowledgement_noun	pAvawI/afBasvIkqwi_(viXi)
acquaintance_noun	paricaya/pariciwa_(vyakwi)
acquire_noun	arjana_karanA
acquisition_noun	arjana
acquit_noun	xoRamukwa_karanA
acquittal_noun	xoRamukwi
acquittane_noun	BarapAI/BugawAna/niswAraNa_(viXi)
act_noun	kAya/kqwya/aXiniyama
action_noun	kAravAI/kriyA
activate_noun	sakriya_karanA
active_noun	sakriya/kriyASIla
activist_noun	karmaTa_kAryakawA/sakriyawAvAxI
activity_noun	kriyAkalApa/gawiviXi
actuals_noun	vAswavika_Akade
actuary_noun	bImAfkaka
adaptable_noun	anukUlanIya/rUpAnwaraNIya
adaptation_noun	anukUlana/rUpAnwara
adcaid-de-camp_)_noun	e-_dI-_sI
add_noun	jodanA
addendum_noun	anuSeRa
addition_noun	yoga/joda/parivarXana
additional_noun	awirikwa/apara_(paxanAma_meM)
address_noun	pawA/afBaBARaNa/samboXana/samboXiwa_karanA/mAnapawra
addressee_noun	pAne_vAlA/prefRawI
addressgraph_noun	pawAleKI
adduce_noun	peSa_karanA
adequacy_noun	paryApwawA
adherence_noun	anuvarwana
adhesive_noun	AsaFjaka
adjacent_noun	pASrvasWa/Asanna/nikatasWa
adjoin_noun	lagA_honA
adjourn_noun	sWagiwa_karanA/kAma_rokanA
adjournment_noun	sWagana
adjudge_noun	TaharAnA_nyAyaniNIwa_karanA_(viXi)
adjudication_noun	nyAyanirNayana
adjudicator_noun	nyAyanirNAyaka
adjuster_noun	samAyojaka
adjustment_noun	samAyojana
adjutant_noun	edjuteMta
administer_noun	praSAsana_karanA/xenA/xilAnA/vyavasWA_karanA
administration_noun	praSAsana
administrative_noun	praSAsanika/praSAsI/praSAsakIya
administrator_noun	praSAsaka
admiral_noun	Edamirala
admissibility_noun	grAyawA:_svIkAryawA
admissible_noun	grAya/svIkArya
admission_noun	svIkqwi/praveSa/xAKilA
admit_noun	praveSa_karane_xenA/anxara_Ane_xenA/svIkAra_karanA/praviRta_karanA/xAKila_karanA/xAKilA_xenA
admittance_noun	praveSa
admitted_noun	praviRta/xAKila/svIkqwa
admonition_noun	BawrsanA
adolescent_noun	kiSora
adopt_noun	afgIkAra_karanA/apanAnA
adoptee_noun	xawwaka
adoption_noun	afgIkaraNa/xawwaka-grahaNa/goxa_lenA
adoptor_noun	xawwakagrAhI
adult_noun	prODa/vayaska
adulterant_noun	apamiSraka
adulteration_noun	apamiSraNa/milAvata
adultery_noun	jArakarma/vyafBacAra
advance_noun	agi_rama/peSagI
advancement_noun	unnawi
advantage_noun	lABa/PAyaxA/BalAI
adverse_noun	prawikUla
advertise_noun	vijFApana_xenA/vijFApiwa_karanA
advertisement_noun	vijFApana
advice_noun	parAmarSa/salAha/sUcanA/saFjFApana
advisory_noun	salAhakAra
advocacy_noun	vakAlawa/pakRa-samarWana
advocate_noun	aXivakwA/edavoketa/pakRa-samarWana
aerial_noun	eriyala/AkASI/havAI
aerodrome_noun	havAI_addA
aeronautical_noun	vEmAnika
aeroplane_noun	vimAna/havAI_jahAja
affairs_noun	kArya/mAmale
affect_noun	praBAva_dAlanA/praBAviwa_karanA
affidavit_noun	SapaWapawra/halaPanAmA
affiliate_noun	sambaxXa_karanA
affiliation_noun	sambanXana
affinity_noun	anurakwi/vivAha_sambanXa
affirm_noun	afBapuRta_karanA/prawijFAna_karanA_(viXi)
affirmation_noun	afBapufRta/prawijFAna_(viXi)
affirmative_noun	sakArAwmaka
affix_noun	lagAnA
afford_noun	praxAna_karanA/xenA/samarWa_honA
afforestation_noun	vana-ropaNa
affranchise_noun	mawAXikAra_xenA
aforesaid_noun	pUvokwa
afternoon_noun	aparAna/xopahara_bAxa
age_noun	Ayu/umra/yuga
agency_noun	afBakaraNa/ejeMsI
agenda_noun	kAryasUcI
agent_noun	afBakarwA/ejeMta
aggrandisement_noun	vivarXana/awikaWana
aggravation_noun	apavqxaf_Xa/guruwara_honA
aggregate_noun	pUrNayoga/kula
aggregation_noun	samuccaya/samUha
aggrieved_noun	vyaWiwa
agitation_noun	Anxolana
agitator_noun	AnxolanakArI
agmark_noun	EgamArka
agrarian_noun	kqfRa_BUmi_sambanXI
agree_noun	karAra_karanA/anubanXa_karanA/sahamawa_honA/rAjI_honA
agreement_noun	karAra_/_anubanXa/sahamawi
agriculture_noun	kqfRa
agro-implements_noun	kqfRa-upakaraNa
agro-industries_noun	kqfRa-uxyoga
agronomist_noun	sasyavijFAnI
agrostologist_noun	GAsavijFAnI
aid_noun	sahAyawA_/_maxaxa
aircraft_noun	vAyuyAna
airfield_noun	havAI_kRewra
airman_noun	vAyu_sEnika/eyaramEna
airport_noun	vimAnapawwana
alarm_noun	Apaxa_safkewa/Kaware_kA_safkewa/alArma/Awafkiwa_karanA
alcohol_noun	ElkohoYla
alderman_noun	pOra-muKya
alertness_noun	sajagawA
alias_noun	urPa
alien_noun	anyaxeSIya
alienable_noun	anyasafkrAmya
alienation_noun	anyasafkrAmaNa
alignment_noun	sareKaNa/sIXa/gaTabanXana
allegation_noun	afBakaWana
alleged_noun	afBakaWiwa
allegiance_noun	niRTA
alliance_noun	mEwrI
allied_noun	sambaxXa
allocation_noun	niyawana/viniXAna
allottee_noun	AbaNtiwi
allow_noun	ijAjawa_xenA/anumawi_xenA
allowance_noun	BawwA/CUta
altenate_noun	ekAnwara/vikalpI
alteration_noun	parivarwana
altercation_noun	kahAsunI
alternative_noun	vikalpa/vEkalpika
alternatively_noun	vikalpawa:
amalgamation_noun	samAmelana
amateur_noun	SOkiyA
ambassador_noun	rAjaxUwa
ambiguous_noun	sanxigXAWI
amend_noun	saMSoXiwa_karanA/saMSoXana_karanA
amendment_noun	saMSoXana
amenity_noun	suKa-suviXA
amicable_noun	sOhArxapUrNa/mEwrIpUrNa
ammunition_noun	golA-bArUxa
amnesty_noun	sarvakRamA
amount_noun	rASi/rakama/mAwrA/miSraXana
anaesthetist_noun	enesWetista/saFjFAharaNavijFAnI
analogous_noun	saxqSa/anurUpa
analogy_noun	sAxqSya/anurUpawA
analysis_noun	viSleRaNa
analyst_noun	viSleRaka
ancestor_noun	pUrvaja
anchorage_noun	lafgaragAha/lafgara_Sulka
ancillary_noun	AnuRafgika/anuRafgI
animal_noun	prANI/janwu_/paSu
animosity_noun	bEra
animus_noun	ASaya/vixveRa
annex_noun	saMlagna_karanA/jodanA/nawWI_karanA/rAjya_meM_milA_lenA
annexe_noun	upaBavana
annexure_noun	saMlagnaka
annihilate_noun	saMhAra_karanA/sarvanASa_karanA
anniversary_noun	varRagATa
annotation_noun	tippaNa_leKana/tIkA/vyAKyA
announce_noun	AKyApana_karanA/ElAna_karanA
announcement_noun	AKyApana/ElAna
announcer_noun	AKyApaka/enAuMsara/vAcaka/uxGoRaka
annoyance_noun	ciDa/KIja
annuity_noun	vAfrRakI
annul_noun	niRpraBAva_karanA/bAwila_karanA
anomaly_noun	asafgawica_viRamawA
anonymous_noun	anAma/gumanAma
answerability_noun	javAbaxehI
answerable_noun	javAbaxeha
antagonist_noun	viroXI
antecedents_noun	pUrvavqwwa
antedated_noun	pUrva-xinAfkiwa
anthropologist_noun	nqvijFAnI/mAnavavijFAnI
anticipation_noun	prawyASA/pUrvAnumAna
anticlockwise_noun	vAmAvarwa
antique_noun	purAvaswu
antiquity_noun	purAwanawA/purAkAla/purAvaswa/u/purAvaSeRa
apartheid_noun	rafgaBexa
apathy_noun	uxAsInawA
apex_noun	SIRA/SiKara
apiarist_noun	maXumakKIpAlaka/maXumakKI_pAlaka
apology_noun	kRamAyAcanA
apparatus_noun	upakaraNa
apparent_noun	prakata/xqSyamAna
appeal_noun	apIla/apIla_karanA
appearance_noun	hAjLrI/upasaFjAwi_(viXi)/Akqwi/rUpa
appeasement_noun	wuRtIkaraNa
appellation_noun	afBayAna
append_noun	pariSiRta_ke_rUpa_meM_lagAnA
appendage_noun	saMlagnaka
appendix_noun	pariSiRta
appliance_noun	upayanwra
applicability_noun	anuprayojyawA/lAgU_honA
applicable_noun	lAgU
applicant_noun	Avexaka
application_noun	Avexana/arjI/anuprayoga/lAgU_(honA)
applied_noun	anuprayukwa
appoint_noun	niyukwa_karanA
appointee_noun	niyukwa_vyakwi
appointment_noun	niyukwi
apportionment_noun	praBAjana
appraiser_noun	mUlyanirUpaka/mUlya-nirUpaka
appreciation_noun	sarAhanA/vqxXi
apprehend_noun	pakadanA/giraPwAra_karanA
apprehension_noun	pakadA_jAnA/giraPwArI/boXa/samaJa/ASafkA
apprentice_noun	SikRu
apprenticeship_noun	SikRuwA
approach_noun	pahuca/upamArga/xqfRtakoNa
appropriate_noun	upayukwa/uciwa/viniyojana_karanA
appropriation_noun	viniyojana
approval_noun	anumoxana
approve_noun	anumoxana_karanA
approver_noun	ikabAlI_gavAha
appurtenance_noun	upAbanXa
aptitude_noun	ruJAna/afBakRamawA
aqueduct_noun	jalavAhI_sewu
arbitrary_noun	manamAnA
arbitration_noun	vivAcana/mAXyasWam_(viXi)
arbitrator_noun	maXyasWa/vivAcaka
arboriculturist_noun	vqkRa-saMvarXana_vijFAnI
archaeologist_noun	purAwawvavix
architect_noun	vAswuvixa/vAswukAra/vAswuvix
architecture_noun	vAswu/vAswuvixyA/sWApawya/sWApawyakalA
archives_noun	afBaleKAgAra
archivist_noun	afBaleKAXyakRa
area_noun	kRewra/kRewraPala
argument_noun	warka/bahasa
armed_noun	saSaswra
armistice_noun	yuxaXa_virAma
armourer_noun	SaswrasAja/Armarara
arms_noun	AyuXa/haWiyAra
army_noun	senA/POja/WalasenA
arrangement_noun	vyavasWA/vinyAsa
arrears_noun	bakAyA
arrival_noun	Agamana
arrivals_noun	Amaxa
arrogance_noun	xamBa/akKadapana
arrogant_noun	xamBI/akKada
arsenal_noun	AyuXAgAra
arson_noun	AgajanI
art_noun	kalA
article_noun	anucCexa/vaswu/leKa/nibanXa
artificer_noun	pariSilpI
artillery_noun	wopaKAnA
artisan_noun	kArIgara/SilpI
artist_noun	kalAkAra
ascend_noun	ArohaNa
ascendant_noun	pUrvapuruRa
ascertain_noun	afBaniSciwa_karanA
aspect_noun	pahalU_/pakRa/xqfRta
aspersion_noun	lAFCana
assailant_noun	hamalAvara
assassination_noun	hawyA/hanana
assault_noun	hamalA/prahAra
assayer_noun	pAraKI
assemble_noun	jutanA/ekawra_honA/ikatTA_honA/jodanA/safmmilawa_karanA/ekawra_karanA
assembly_noun	saBA/jamAva
assent_noun	anumawi
assert_noun	xqDawA_se_kahanA/jora_xekara_kahanA
assessee_noun	nirXAriwI
assessment_noun	nirXAraNa
assessor_noun	asesara/kara-nirXAraka
assets_noun	parisampafwwa/AswiyA
assign_noun	samanuxeSiwa_karanA/sOMpanA/niyawa_karanA
assignee_noun	samanuxeSiwI
assignment_noun	samanuxeSana/supurxa_kAma
assignor_noun	samanuxeSaka
assimilate_noun	AwmasAwkaranA
assimilation_noun	milAnA/AwmasAwkaraNa
assistant_noun	sahAyaka
associate_noun	saha-_safmmaliwa_karanA
association_noun	safGa_safgama_(viXi)_sambanXa/sAhacarya
assume_noun	grahaNa_karanA/kalpanA_karanA
assumption_noun	grahaNa/kalpanA
assurance_noun	ASvAsana/bImA_(haswAnwaraNa-pawra
assure_noun	ASvaswa_karanA
atmosphere_noun	vAyumaNdala
attach_noun	sAWa_lagAnA/saMlagna_karanA/kurka_karanA
attache_noun	awASe/sahacArI
attached_noun	saMlagna
attachment_noun	saMlagnaka/kukIZ
attainment_noun	labXi/prApwi
attempt_noun	prayawna_karanA/prayawna
attend_noun	upasWiwa_honA/hAjLra_honA
attendance_noun	upasWiwi/hAjLrI
attendant_noun	paricara
attender_noun	paricara
attention_noun	XyAna/sAvaXAna
attest_noun	anupramANiwa_karanA/wasaxIka_karanA
attestation_noun	anupramANana/wasaxIka
attitude_noun	afBavqfwwa
attorney_noun	nyAyavAxI/atarnIZ
auction_noun	nIlAmI
auctioneer_noun	nIlAmakarwA
audible_noun	Sravya
audience_noun	SrowA/xarSaka/xarSana/sunavAI
audit_noun	leKAparIkRA
auditor_noun	leKAparIkRaka/oYditara
auditorium_noun	prekRAgqha/oYditoriyama
augmentation_noun	AvarXana
austerity_noun	miwopaBoga/sAxagI
authentic_noun	prAmANika
authenticate_noun	pramANiwa_karanA
authentication_noun	pramANIkaraNa
authoritative_noun	prAXikqwa/prAXikArika
authority_noun	prAXikArI(vyakwi)/prAXikAra/prAXikaraNa(saMsWA)/aXikArI_vixvAna
authorization_noun	prAXikAra
authorize_noun	prAXikqwa_karanA
authorized_noun	prAXikqwa
autograph_noun	svAkRara/apane_haswAkRara
automatic_noun	svacAliwa
automobile_noun	motaragAdI
autonomous_noun	svAyawwa
autonomy_noun	svAyawwawA
auxiliary_noun	sahAyaka/awirikwa
available_noun	prApya/upalabXa
aver_noun	prakaWana_karanA
average_noun	Osawa/sAmAnya(riporta)
averment_noun	prakaWana
aversion_noun	viruci/viwqRNA
avert_noun	bacA_lenA
aviation_noun	vimAnana
avocation_noun	upavyavasAya
avoid_noun	varjana_karanA/parihAra_karanA/bacanA
avoidable_noun	parihArya
awakening_noun	jAgaraNa/jAgqwi
award_noun	paFcAta/aXinirNaya/puraskAra
awareness_noun	BAna/boXa/jAgarUkawA
awkward_noun	BaxxA
axiom_noun	svayaMsixaf_Xa
ayes_noun	hA_pakRa
backdated_noun	pUrva-xinAfkiwa
background_noun	pqRTaBUmi
bacteriologist_noun	jIvANu_vijFAnI
badge_noun	bEja/billA
baggage_noun	asabAba
bail_noun	jamAnawa
bailiff_noun	beliPa
bailment_noun	apaniXAna
baker_noun	bekara
balance_noun	SeRa/bAkI/sanwulana/wulA/warAjU
ballot_noun	mawapawra_mawaxAna
ban_noun	prawibanXa/roka/pAbanxI
band_noun	pattI_/bEMda_/xala
bandsman_noun	bEMdamEna
banishment_noun	xeSanikAlA
bank_noun	bEMka_/wata/kinArA_/sAhUkArI_karanA
banker_noun	bEMkara
banking_noun	bEMkiMga/bEMkakArI
bankrupt_noun	xivAliyA
bankruptcy_noun	xivAlA/xivAliyApana
banner_noun	bEnara/praxarSa_patta
banquet_noun	Boja/mahABoja
bar_noun	roXa/rukAvata
bargain_noun	sOxA/sOxA_karanA
barman_noun	bAramEna
barrack_noun	bEraka
barrage_noun	barAja
barren_noun	baFjara/anurvara/bAJa/banXyA
barrier_noun	roXa/avaroXa/nAkA
barrister_noun	bEristara
barter_noun	vaswu_vinimaya
base_noun	AXAra
basement_noun	wahaKAnA
basic_noun	mUla/buniyAxI
batch_noun	yAna/Kepa/bEca/tolI
batten_noun	bawwA/bEtana
batteryman_noun	bEtarImEna/bEtarIvAlA
bearer_noun	vAhaka/bErA
beaterman_noun	gEMwIvAlA
beatman_noun	gaSwavAlA
bedding_noun	biswara/biCOnA
beekeeper_noun	maXumakKI-pAla
behaviour_noun	vyavahAra
belief_noun	viSvAsa
beltman_noun	pattevAlA
bench_noun	nyAyapITa/beMca
benchmark_noun	wala_cihna
bend_noun	moda/JukanA/mudanA/modanA
beneficial_noun	lABapraxa
beneficiary_noun	hiwaBAgI/lABArWIZ
benefit_noun	hiwa/lABa/PAyaxA/hiwalABa
benevolence_noun	hiwakAriwA
bequeath_noun	vasIyawa_karanA/vasIyawa_xvArA_xenA
bequest_noun	vasIyawa
bereaved_noun	Sokasanwapwa
betray_noun	viSvAsaGAwa_karanA
betterment_noun	KuSahAlI/unnawi/suXAra
beverage_noun	peya
bias_noun	afBanawi/JukAva
bibliographer_noun	granWasUcIkAra/granWa-sUcIkAra
bibliography_noun	granWasUcI
bicameral_noun	fxvasaxana/fxvasaxanI
bid_noun	bolI/bolI_lagAnA
bidding_noun	bolI_lagAnA
biennial_noun	fxvavAfrRaka
bifurcate_noun	xo_BAgoM_meM_batanA/xo_BAgoM_meM_bAtanA/fxvaBAjana
bigamy_noun	fxvavivAha(praWA)
bilateral_noun	fxvapakRIya
bilingual_noun	fxvaBARI
bill_noun	viXeyaka_bila
binder_noun	jilxasAja
binding_noun	bAXyaka/banXanakArI
biochemist_noun	jIvarasAnajFa
biodata_noun	jIvanavqwwa
biologist_noun	jIvavijFAnI
bipartite_noun	fxvaxalIya/fxvapakRIya/uBayapakRI
birthplace_noun	janma-sWAna
biweekly_noun	pAkRika/arXa-sApwAhika
blacksmith_noun	luhAra/lohakAra
blank_noun	korA/sAxA/nirafka/KAlI/rikwa
blast_noun	XamAkA
blending_noun	safmmaSraNa
block_noun	KaNda/bloYka
blockade_noun	nAkAbanxI
blueprint_noun	blUfpraNta/KAkA
bluff_noun	JAsA
board_noun	borda/maNdala
boarder_noun	AvAsI
body_noun	nikAya
bodyguard_noun	afgarakRaka
bogey_noun	bogI
bombardment_noun	golAbArI/bamavaRAZ
bonafide_noun	vAswavika/saxBAva/saxBAvI/saxASayI
bonafides_noun	nekanIyawI/saxBAva/saxASayawA
bond_noun	banXapawra/boYNda
bonus_noun	bonasa
book-keeper_noun	bahI_leKaka/munIma
book-keeping_noun	bahIKAwA_liKanA/bahIKAwA_paxXawi
book_noun	puswaka_/bahI
booking_noun	buka_karanA/bukiMga
booklet_noun	puswikA
boom-man_noun	bUma_mEna
booth_noun	bUWa
borrow_noun	uXAra_lenA
borrower_noun	uXArakarwA
bottleneck_noun	gawyavaroXa
boundary_noun	sImA
bowman_noun	bomEna
box_noun	baksa/petI
boy_noun	boYya
boycott_noun	bahiRkAra/boYyakAta
bracket_noun	koRTaka
bracketing_noun	koRTakiwa_karanA
brake_noun	breka_roka
brakesman_noun	brekamEna
branch_noun	SAKA
brand_noun	CApa
breach_noun	Bafga
break-up_noun	byorA
breakage_noun	tUta-PUta
breed_noun	nasla
breeder_noun	prajanaka
breeding_noun	prajanana
brevity_noun	safkRipwawA
brewery_noun	maxyanirmANaSAlA
bribe_noun	GUsa/riSvawa
bribery_noun	GUsaKorI/riSvawaKorI
brief_noun	safkRipwa/pakRAsAra/brIPa
briefing_noun	pawrasAra
brigade_noun	brigeda
brigadier_noun	brigediyara
brilliant_noun	prawiBAvAna
broadcast_noun	prasAraNa
broadsheet_noun	badA_citTA
brochure_noun	vivaraNikA
broker_noun	xalAla
brokerage_noun	xalAlI
budget_noun	bajata/Aya-vyayaka
buffer_noun	baPara
bugler_noun	bigulara
building_noun	Bavana/imArawa
bulk_noun	Woka/ambAra/Dera/aXikAMSa/parimANa
bulletin_noun	buletina
bumper_noun	bampara_joraxAra/BarapUra
bunching_noun	gucCana
bungling_noun	golamAla/golamAla_karanA
burden_noun	BAra
bureau_noun	byUro
bureaucracy_noun	aXikArI_wanwra/xaPwaraSAhI
bureaucrat_noun	aXikArI/xaPwaraSAha
burser_noun	barsara/koRa-aXIkRaka
burst_noun	PatanA
business_noun	vyavasAya/kArobAra
butler_noun	batalara
buyer_noun	krewA/KarIxAra
cabin_noun	kebina
cabinet_noun	manwrimaNdala/alamArI/petikA
cablegram_noun	samuxrI_wAra
cadre_noun	saMvarga/kAdara
calamity_noun	vipafwwa
calculation_noun	parikalana
calculator_noun	parikaliwra
calender_noun	kEleMdara/sUcI
calligraphist_noun	suleKakAra/KuSanavIsa
calling_noun	vyavasAya/AjIvikA
cameraman_noun	kEmarAmEna
camp_noun	Sivira/kEMpa
campaign_noun	afBayAna
camper_noun	Siviraka
cancel_noun	raxxa_karanA
cancellation_noun	raxxa_karanA
candidate_noun	aByaWIZ/ummIxavAra
candidature_noun	aByarWiwA/ummIxavArI
cantonment_noun	CAvanI
canvassing_noun	mawArWana/mawa-yAcanA/vota_mAfganA/pakRa-pracAra
capability_noun	sAmaWrya
capable_noun	samarWa
capacity_noun	hEsiyawa_/kRamawA_/sAmaWrya_/XAriwA
capital_noun	pUjI/mUlaXana/swamBaSIrRa/rAjaXAnI/mqwyu_se_xaNdanIya_xIGAkRara
captain_noun	kapwAna/kEptana
capture_noun	pakadanA/banxI_banAnA
cardiologist_noun	hqxayaroga_viSeRajFa
care_noun	sAvaXAnI/paravAha/xeKaBAla/raKavAlI
career_noun	vqfwwa/jIvikA/kEriyara/jIvana
caretaker_noun	keyaratekara/raKavAla/keyara_tekara
cargo_noun	jahAjI_mAla/kAgoZ
carpenter-cum-smith_noun	baDaI_va_luhAra
carpenter_noun	baDaI
carriage_noun	gAdI/vAhana/savArI_dibbA/DulAI
carrier_noun	vAhana_/vAhaka
cartage_noun	gAdI_BAdA/DulAI
cartographer_noun	mAnaciwrakAra/nakSAnavIla
cartoonist_noun	vyafgya-ciwrakAra
case_noun	mAmalA/prakaraNa/fsWfAwa/viRaya/mukaxmA
cash_noun	rokada/nakaxa/nakaxI/BunAnA
cashier_noun	koRapAla
caste_noun	jAwi
caster_noun	DalAIkAra
casual_noun	Akafsmaka_aniyawa
casualties_noun	hawAhawa
casualty_noun	xuGatanA_Ahawa/GAyala/mqwa
catalogue_noun	sUcI/sUcIpawra
cataloguer_noun	sUcIkAra
categorical_noun	suniSciwa/suspaRta
category_noun	varga/SreNI/xajAZ/koti
caterer_noun	KAnapAna_prabanXaka/Boja_prabanXaka
catering_noun	Bojana_prabanXa
caution_noun	KabaraxAra/sAvaXAna/sAvaXAnI
celebration_noun	samAroha
cell_noun	prakoRTa
censor_noun	seMsara
censure_noun	niMxA/pariniMxA(viXi)
census_noun	janagaNanA
central_noun	keMxrIya/keMxra
centralization_noun	keMxrIyakaraNa/keMxrIkaraNa
centre_noun	keMxra
century_noun	SawAbxI/SawI/saxI/Sawaka
ceramist_noun	mqfwwakASilpI
cereal_noun	XAnya/anAja
cerealist_noun	XAnyavix
ceremonial_noun	samAroha
ceremony_noun	samAroha_/gqhakarma
certificate_noun	pramANapawra
certification_noun	pramANana/pramANIkaraNa
certify_noun	pramANiwa_karanA/wasaxIka_karanA/pramANa_xenA
cess_noun	upakara
cessation_noun	samApwi
chain_noun	jaFjIra/kadI/jarIba/SrqfKalA
chainman_noun	jarIbI/cenamEna
chairman/chair-pers_noun	aXyakRa/saBApawi
chairman_noun	saBApawi/aXyakRa
challan_noun	cAlAna
challandar_noun	cAlAnaxAra
challenge_noun	cunOwI_Apafwwa
chamber_noun	ceMbara/kakRa_/maNdala
chancellor_noun	kulAXipawi
chancery_noun	cAMsarI
change_noun	baxalanA/parivarwana
channel_noun	mAXyama/saraNi
chaos_noun	avyavasWA
chapter_noun	aXyAya/SAKA/cEptara
character_noun	cariwra
charge_noun	Aropa/cArja/praBAra/Karca/kArya-BAra/XAvA
chargeable_noun	praBArya
charged_noun	praBAriwa_/Aropiwa
chargehand_noun	cArjahEMda/kAryAvekRaka
chargeman_noun	cArjamEna/kAryekRaka
charitable_noun	XarmArWa/KErAwI/pUrwa_(viXi)
charity_noun	XarmAxA/KErAwa
chart_noun	cArta/saFciwra
charter_noun	BAde_para_lenA/cArtara
chaser_noun	cejara
cheating_noun	Cala/Cala_karanA
check_noun	padawAla/jAca/roka/milAna_karanA
checker_noun	padawAlakarwA/cekara
chemist_noun	rasAyanajFa_kEmista/ORaXavyavasAyI
cheque_noun	cEka
chest_noun	wijorI
chief_noun	muKya
chorus_noun	vqnxagAna
chowkidar_noun	cOkIxAra
chronic_noun	jIrNa/cirakAlika/cirakArI
chronology_noun	kAlakrama
circle_noun	maNdala/safrkala/halakA
circular_noun	paripawra/gaSwI_citTI
circulation_noun	paricAlana
circumstances_noun	parisWiwiyA
citation_noun	uxXaraNa_/praSaswi
citizenship_noun	nAgarikawA
city_noun	nagara/Sahara
civil_noun	sivila/nAgarika/asEnika/xIvAnI
claim_noun	xAvA/xAvA_karanA
claimant_noun	xAvI/xAvexAra
clarification_noun	spaRtIkaraNa
class_noun	varga/xajAZ/klAsa/kakRA/SreNI
classwise_noun	vargavAra/SreNIvAra
clause_noun	KaNda
cleaner_noun	klInara
clearance_noun	samASoXana(bEMkiMga)/nikAsI/anumawi
clerical_noun	lipikIya_/leKana_sambanXI
clerk_noun	lipika/klarka/bAbU/muMSI/bAbU_
climatologist_noun	jalavAyu_vijFAnI
clinic_noun	fklanika/nixAnAlaya
clockwise_noun	xakRiNAvarwa
close_noun	samApwi
closure_noun	samApana/samApwi
clue_noun	sUwra/safkewa
co-accused_noun	saha-afBayukwa
co-education_noun	saha-SikRA
co-examiner_noun	saha-parIkRaka
co-exixtence_noun	saha-aswiwva
co-heir_noun	saha-vArisa
co-pilot_noun	saha-vimAna_cAlaka/ko-pAilata
coach_noun	gAdI/dibbA/koca/anuSikRaka
coastal_noun	watIya/watavarwI
code_noun	saMhiwA_koda/safkewa/kUta
codification_noun	saMhiwAkaraNa
codify_noun	saMhiwAbaxXa_karanA/saMhiwAkaraNa
coding_noun	kUta_leKana
coercion_noun	jora-jabaraxaswI/prapIdana/balaprayoga
cognizable_noun	saFjFeya
cognizance_noun	saFjFAna/XyAna
coherence_noun	susafgawi/sambaxXawA
coincidence_noun	saMyoga/sampAwa
collaboration_noun	sahayoga
colleague_noun	sahakarmIZ/sahayogI
collective_noun	sAmUhika
collector_noun	kalaktara/safgrAhaka/samAharwA/jilAXISa/jilAXikArI
collectorate_noun	kalaktarI/samAharwAlaya
college_noun	mahAvixyAlaya/koYleja
colliery_noun	koyalA_KAna
collusion_noun	xurafBasanXi
colonel_noun	karnala
colonization_noun	upaniveSana
colony_noun	upaniveSa_baswI/koYlonI
column_noun	swamBa/KAnA
columnist_noun	swamBa-leKaka
comity_noun	sOhArxa
command_noun	kamAna/samAxeSa
commandant_noun	kamANdEMta
commander-in-chief_noun	kamANdara-ina-cIPa
commander_noun	kamANdara
commemoration_noun	smqwi/smaraNowsava
commencement_noun	prAramBa
commendable_noun	praSaMsanIya/sarAhanIya
commendation_noun	praSaMsA/sarAhanA
commensurate_noun	anurUpa
commentary_noun	vyAKyA/AKoM_xeKA_hAla
commentator_noun	vivaraNakAra/tIkAkAra
comments_noun	tippaNI
commerce_noun	vANijya
commission_noun	Ayoga/kamISana/ADawa/(aparAXa)_karanA
commissionaire_noun	xvArapAla
commissioner_noun	Ayukwa/kamiSnara
commissioning_noun	pravarwana_meM_lAnA/cAlU_karanA
commit_noun	karanA/supurxa_karanA/vacanabaxXa_honA
commitment_noun	supurxagI/prawibaxXawA(viXi)
committee_noun	samiwi
commodity_noun	vaswu/paNya
commodore_noun	kamodora
common_noun	sAmAnya
communal_noun	sAmpraxAyika/sAmuxAyika
communicate_noun	sanxeSa_pahucAnA/bawAnA/saFcAriwa_karanA/saMsUciwa_karanA/bAwacIwa_karanA/samparka_karanA/sampreRaNa_karanA
communication_noun	saFcAra/saMsUcanA/sanxeSa/pawravyavahAra/sampreRaNa
communique_noun	vijFapwi
community_noun	samuxAya/samAja
commutation_noun	parivarwana/sarAMSIkaraNa/laGukaraNa
comparer_noun	milAnakarwA
comparison_noun	wulanA/milAna
compartment_noun	upaKaNda/kakRa/KAnA/rela_dibbA
compassion_noun	anukampA
compatible_noun	safgawa/saMyojya
compel_noun	vivaSa_karanA
compendium_noun	sAra-safgraha
compensation_noun	prawipUrwi/prawikAra/muAvajA/kRawipUrwi
compere_noun	paricAyaka
competence_noun	sakRamawA
competent_noun	sakRama
compilation_noun	safkalana
compiler_noun	safkalanakarwA
complaint_noun	SikAyawa/parivAxa(viXi)
complement_noun	pUraka
complementary_noun	pUraka
complete_noun	pUrNa/pUrA_karanA/samApwa_karanA
compliance_noun	anupAlana/pAlana
complicated_noun	jatila/ulaJA_huA/pecIxA
compliment_noun	praSaMsA/praSaMsA_karanA/baXAI_xenA/samAxara
complimentary_noun	mAnArWa
composition_noun	racanA/nirmANa/miSraNa/safmmaSraNa/safGatana/gaTana_praSamana(_Na_kA)
compositor_noun	kampojItara
compounder_noun	kampAuNdara
comprehensive_noun	vyApaka/bqhawa
compromise_noun	samaJOwA/samaJOwA_karanA
compulsory_noun	anivArya
computer_noun	kampyUtara/afBakaliwra
concentration_noun	ekAgrawA/safkeMxraNa
concept_noun	avaXAraNA/safkalpanA
concern_noun	prawiRTAna/sarokAra/ciMwA
concession_noun	riyAyawa
conciliation_noun	sulaha
conclusion_noun	niRkarRa/anwa
conclusive_noun	niScayAwmaka/niScAyaka
concur_noun	sahamawa_honA
concurrence_noun	sahamawi
condemn_noun	anupayogI_GofRawa_karanA/xaNdanIya_GofRawa_karanA/niMxA_karanA
condition_noun	Sarwa/prawibanXa_xaSA/fsWfAwa
conditional_noun	saSarwa
condolence_noun	samavexanA/Soka
condone_noun	mAPa_karanA
conduct_noun	AcaraNa/saFcAliwa_karanA
conductor_noun	saFcAlaka(kAryakrama_kA)/saMvAhaka/kaNdaktara(jEse_basa_kA)/kaNdaktara
confer_noun	praxAna_karanA/vicAra-vimarSa_karanA
conference_noun	sammelana
conferred_noun	praxawwa
confession_noun	ikabAla/saMsvIkqwi(viXi)
confidence_noun	viSvAsa/BarosA
confidential_noun	gopanIya/anwarafga
confinement_noun	pariroXa/prasUwi
confirm_noun	pufRta_karanA
confirmation_noun	pufRta/sWAyIkaraNa
confiscation_noun	aXiharaNa/jabwI
conflict_noun	safGarRa/viroXa
conformity_noun	anurUpawA
connect_noun	sambaxXa_karanA/jodanA
connected_noun	sambaxXa
connivance_noun	milIBagawa/mOnAnukUlawA(viXi)
conscience_noun	anwa:karaNa
conscription_noun	anivArya_sEnika_BarwIZ
consecutive_noun	kramika/lagAwAra
consensus_noun	mawEkya
consent_noun	sahamawi
consequence_noun	pariNAma/Pala
consequent_noun	anuvarwIZ/pariNAmI
conservancy_noun	mala_saPAI
conservation_noun	saMrakRaNa
consideration_noun	vicAra_prawiPala
consignee_noun	parefRawI
consignment_noun	pareRaNa
consignor_noun	pareRaka
consistent_noun	ekarUpa/safgawa
consolidation_noun	cakabanxI/samekana/suxqDIkaraNa
conspectus_noun	xigxarSana/sanxarSikA/safkRipwa_vivaraNa
conspicuous_noun	sahaja_xqSya/XyAnAkarRIZ
conspiracy_noun	RRadyanwra
constable_noun	sipAhI/kAMstebala
constituency_noun	nirvAcana_kRewra
constituent_noun	safGataka
constitute_noun	gaTana_karanA
constitution_noun	safGatana/gaTana/saMviXAna
construction_noun	nirmANa/racanA
constructive_noun	racanAwmaka/pralakRiwa(jEse_supurxagI)
construe_noun	arWa_lagAnA
consul_noun	kAMsula
consulate_noun	kAMsulAvAsa
consultant_noun	parAmarSaxAwA
consultation_noun	parAmarSa
consume_noun	upaBoga_karanA/KapanA
consumption_noun	upaBoga/Kapawa
contact_noun	samparka/saMsparSa/sparSa
contagious_noun	sAMsagika
contain_noun	samAviRta_karanA
contaminate_noun	sanxUfRawa_karanA
contamination_noun	sanxURMMANa
contemplated_noun	avekRiwa
contemporary_noun	samasAmayika/samakAlika
contention_noun	vivAxa/xAvA/prawiviroXa_(viXi)
contents_noun	viRaya_sUcI/anwarvaswu/aMSa
contest_noun	vivAxa/prawiyogiwA/ladanA(jEse_nirvAcana)
context_noun	sanxaBa/prasafga
contingencies_noun	Akafsmaka_vyaya
contingency_noun	samBAvya_fsWfAwa/AkafsmakawA
contingent_noun	tukadI/xala/Akafsmaka/prAsafgika/samAfSrawa_(viXi)
contraband_noun	vinifRaxXa
contract_noun	TekA/saMvixA
contractor_noun	TekexAra/saMvixAkAra
contradict_noun	prawivAxa_karanA/KaNdana_karanA
contradiction_noun	prawivAxa/KaNdana
contradictory_noun	viroXAwmaka
contrary_noun	prawikUla/viparIwa
contravention_noun	ullafGana
contribution_noun	aMSaxAna/canxA_yogaxAna
controller_noun	niyanwraka
controversial_noun	vivAxAspaxa
controversy_noun	vivAxa
convene_noun	saMyojana_karanA/bulAnA_(bETaka)
convener_noun	saMyojaka
convenience_noun	suviXA
convention_noun	paripAtI/rUfDa/samAgama/afBasamaya
conventional_noun	rUDa/rUfDagawa
conversion_noun	parivarwana
convert_noun	parivarwiwa_karanA/samparivarwiwa_(viXi)
convey_noun	sUciwa_karanA/pahucAnA/haswAnwaraNa_karanA_(viXi)
conveyancer_noun	haswAnwaraNa_leKaka/haswAnwaraka
convict_noun	sixXaxoRa/sixXaxoRa_TaharAnA
convocation_noun	xIkRAnwa_samAroha
cook_noun	rasoiyA/bAvarcIZ
cookmate_noun	sahAyaka_rasoiyA
cooperation_noun	sahayoga/sahakAriwA
cooperative_noun	sahakArI/sahayogaSIla
coopt_noun	sahayojiwa_karanA
coopted_noun	sahayojiwa
coordination_noun	samanvaya/wAlamela
coordinator_noun	samanvayaka/samanvayI/samanvayakarwA
coowner_noun	sahasvAmI
copartner_noun	sahaBAgIxAra
copy_noun	prawilipi/nakala/prawi
copyright_noun	koYpIrAita/svawvAXikAra/prakASanAXikAra
cordial_noun	sOhArxapUrNa
corner_noun	mqwyu_samIkRaka/kAronara
corporal_noun	kAporala
corporation_noun	nigama
corps_noun	kora
correction_noun	BUla-suXAra/suXAra/xoRa-suXAra
correspond_noun	pawra_vyavahAra_karanA/pawrAcAra_karanA/samarUpa_honA/mela_KAnA/samAna_honA
correspondence_noun	pawrAcAra/pawravyavahAra
correspondent_noun	saMvAxaxAwA/samparkI
corresponding_noun	waxanurUpa/waxanusAra
corrigendum_noun	SuxfXa-pawra/BUla_suXAra
corroborate_noun	sampufRta_karanA
corroboration_noun	sampufRta
corrupt_noun	BraRta/BraRta_karanA
corruption_noun	BraRtAcAra
cost_noun	lAgawa
council_noun	pariRax
councillor_noun	pArRaxa
counsel_noun	kAuMsala/parAmarSa_xenA/manwraNA_xenA/kAuMsela
counselling_noun	parAmarSa_sevA/parAmarSa/upaboXana
counsellor_noun	parAmarSaxAwA
count_noun	ginanA/gaNanA_karanA
counter_noun	kAuNtara/patala/prawi/javAbI/gaNiwra
counterfeiting_noun	kUtakaraNa
counterfoil_noun	prawiparNa/aXapannA
counterpart_noun	prawisWAnI
countersign_noun	prawihaswAkRara_karanA
countersignature_noun	prawihaswAkRara
coupon_noun	kUpana
courier_noun	vArwAhara/kUriyara
course_noun	mArga/xiSA/krama/viXi/prakriyA/pATyakrama
court_noun	nyAyAlaya/korta
courtesy_noun	sOjanya/SiRtAcAra
covenant_noun	prasaMvixA
cover_noun	AvaraNa/liPAPA
craftsman_noun	SilpakAra/SilpI
cranage_noun	krena_BAdA
craneman_noun	krenamEna
creche_noun	SiSu_saxana/bAlavAdI
credibility_noun	viSvasanIyawA/sAKa
credit_noun	uXAra/prawyaya/sAKa/jamA/kredita
creditable_noun	praSaMsanIya/sarAhanIya
creditor_noun	lenaxAra/_NaxAwA
crew_noun	karmIxala
crime_noun	aparAXa
crisis_noun	safkata
criterion_noun	mAnaxaNda/kasOtI
cross_noun	kroYsa_lagAnA/safkara/kAta_xenA
crude_noun	kaccA/apariRkqwa/aSoXiwa
culprit_noun	aparAXI/xoRI
cultivation_noun	KewI/karRaNa
cultivator_noun	Kewihara/kaltIvetara_(yanwra)
cumulative_noun	saFcayI
cupolaman-in-charge_noun	gumbaxiyA_iMcArja
cupolaman_noun	gumbaxiyA
curator_noun	safgrahAXyakRa/kyUretara
currency_noun	kareMsI/muxrA
current_noun	cAlU/pracaliwa
curtail_noun	kama_karanA
custodian_noun	afBarakRaka
custody_noun	afBarakRA/hirAsawa
customary_noun	rUfDagawa
customer_noun	grAhaka/gAhaka
customs_)_noun	sImA-Sulka
cut_noun	karwana/kAta_katOwI
cyclostyle_noun	sAiklostAila_karanA
cytogeneticist_noun	koSikAnuvaMSikavijFAnI
cytologist_noun	koSikAvijFAnI
daftry_noun	xaPwarI
daily_noun	xEnika
dairyman_noun	derIvAlA
dais_noun	maFca
damages_noun	hajAnA/nukasAnI_(viXi)
dandyman_noun	dAdIvAlA
data_noun	AXAra_sAmagrI_Akade/dAtA
date_noun	xinAfka/wiWi/wArIKa
dated_noun	xinAfkiwa/wArIKa_kA/wArIKI
de-requisition_noun	aXigrahaNa-mocana
deadlock_noun	gawiroXa
deadweight_noun	kula_BAra
deal_noun	sOxA/vyavahAra_karanA
dealing_noun	vyavahAra/barwAva
dealings_noun	vyavahAra/lenaxena
death-cum-retirement_noun	mqwyu-saha-nivqfwwa_upaxAna
debar_noun	rokanA/vivarjiwa_karanA_(viXi)
debarment_noun	roka/vAraNa/vivarjana
debenture_noun	dibeMcara
debit_noun	nAme/debita/nAme_dAlanA
debt_noun	_Na
debtor_noun	xenaxAra/_NI
decency_noun	SiRtawA
decentralization_noun	vikeMxrIkaraNa
decision_noun	nirNaya/PEsalA/viniScaya_(viXi)
declaration_noun	GoRaNA
declare_noun	GoRaNA_karanA/GofRawa_karanA
decode_noun	kUtavAcana
decontrol_noun	viniyanwraNa
decoration_noun	alafkaraNa_/sajAvata
decorum_noun	SiRtawA/SAlInawA
decrease_noun	Gatawa/kamI
decree_noun	digarI/dikrI
decypher_noun	bIjaleKavAcana
dedication_noun	samarpaNa
deduction_noun	katOwI/GatAva
deed_noun	vileKa_(viXi)_karma
deface_noun	virUpiwa_karanA
defalcation_noun	gabana
defamation_noun	mAnahAni
default_noun	cUka/vyawikrama/bakAyA/aBAva
defaulter_noun	cUka_karane_vAlA/vyawikramI/bakAyAxAra/bAkIxAra
defective_noun	wrutipUrNa
defence_noun	rakRA/bacAva/prawivAxa_(viXi)
defendant_noun	prawivAxI
defer_noun	AsWagiwa_karanA
deferred_noun	AsWagiwa
defiance_noun	avajFA
deficiency_noun	kamI/nyUnawA
deficit_noun	GAtA/kamI
define_noun	niSciwa_karanA/pariBARA_xenA
defy_noun	avajFA_karanA
degradation_noun	paxa_GatAnA/greda_GatAnA
degree_noun	digrI/upAXi/upAXipawra/mAwrA/aMSa/aMSAfka/koti/GAwa
delay_noun	vilamba
delegate_noun	prawiniXi/prawyAyojiwa_karanA/xe_xenA/sOMpanA
delegation_noun	prawiniXi_prawyAyojana
deletion_noun	lopa/hatA_xiyA_jAnA
deliberately_noun	jAnabUJakara
deliberation_noun	vicAra-vimarSa/vimarSa
deliceacing_noun	lAiseMsa_raxxa_karanA/lAiseMsa_hatAnA
delimitation_noun	parisImana
delinquency_noun	apacAra
deliver_noun	xenA/sOMpanA/janma_xenA/jananA
delivery_noun	viwaraNa/supurxagI/parixAna(viXi)/prasava
demand_noun	mAga/afBayAcanA
demarcation_noun	sImAfkana
demi-official_noun	aXaZ-SAsakIya
democratic_noun	lokawAnwrika
demographer_noun	janasAMfKyaka
demonstration_noun	praxarSana_nixarSana/nirUpaNa_pramANa
demonstrator_noun	nixarSaka
demoralization_noun	manobala-hAsa
demote_noun	paxAvanawa_karanA/paxa_GatAnA
demotion_noun	paxAvanawi
demurrage_noun	vilamba-Sulka/demareja
denial_noun	prawyAKyAna(viXi)/inakAra/nakAra
denomination_noun	afBayAna/afkiwa_mUlya/panWa(XArmika)/mUlyavarga
dentist_noun	xanwa-cikiwsaka
deny_noun	prawyAKyAna_karanA(viXi)/nakAranA
depart_noun	prasWAna_karanA/ravAnA_honA/vicaliwa_honA/hatanA/xivafgawa_honA/maranA
department_noun	viBAga
departmental_noun	viBAgIya
departure_noun	prasWAna_vicalana
dependent_noun	AfSrawa
deploy_noun	wEnAwa_karanA
deployment_noun	pariniyojana
deponent_noun	afBasAkRI
deportation_noun	xeSanikAlA/vivAsana(viXi)
depose_noun	afBasAkya_xenA/gavAhI_xenA
deposit_noun	nikRepa/jamA
depositor_noun	jamA_karane_vAlA/jamAkarwA
depository_noun	nikRepAgAra
depot_noun	dipo/AgAra
depreciation_noun	mUlyahAsa/avakRaya
deprive_noun	vaFciwa_karanA
deputation_noun	prawiniyuwi_SiRtamaNdala
deputationist_noun	prawiniyakuwa
deputy_noun	upa
deregistered_noun	vipaFjIkqwa
dereservation_noun	vi-ArakRaNa
dermatologist_noun	wvacAvijFAnI
derogation_noun	anAxara_alpIkaraNa
derogatory_noun	anAxarasUcaka
descendant_noun	vaMSaja
description_noun	varNana/vivaraNa
descriptive_noun	varNanAwmaka/vivaraNAwmaka
deserving_noun	supAwra
design_noun	afBakalpa/dijAina/afBakalpana/rUpAfkana
designate_noun	nAmoxxiRta_karanA_afBahiwa_karanA
designation_noun	paxanAma/paxa
designer_noun	afBakalpa/dijAinakAra/rUpakAra
despatch_noun	preRaNa/ravAnagI/prefRawa_karanA/ravAnA_karanA/BejanA
despatcher_noun	preRaka/BejanevAlA
destination_noun	ganwavya_lakya
destitute_noun	nirAfSrawa
detail_noun	byorA
detect_noun	pawA_lagAnA/pakadanA
detection_noun	Koja/pawA_lagAnA
detective_noun	gupwacara/jAsUsa
detention_noun	niroXa/najarabanxI
detenu_noun	najarabanxa/nirUxXa_vyakwi
determination_noun	nirXAraNa/avaXAraNa(viXi)/safkalpa
detriment_noun	ahiwa
detrimental_noun	ahiwakara
devaluation_noun	avamUlyana
devastation_noun	viXvaMsa/vinASa
development_noun	vikAsa
deviate_noun	vicaliwa_honA
deviation_noun	vicalana/anwara
device_noun	yukwi_sAXana
devotion_noun	niRTA
diagnose_noun	nixAna_karanA
diagram_noun	AreKa
dialogue_noun	saMvAxa
diarise_noun	dAyarI_karanA
diarist_noun	dAyarI_leKaka
diary_noun	dayarI_xEnikI/xEnanxinI
dict_noun	AhAra
dictation_noun	SruwaleKa
dictician_noun	AhAravix
digest_noun	sAra-safgraha/cayanikA
dignified_noun	garimApUrNa
dignitary_noun	gaNyamAnya/gaNyamAnya_vyakwi
dignity_noun	gOrava/maryAxA/garimA
digression_noun	viRayAnwaraNa
dilatory_noun	vilambakArI
dilemma_noun	xuviXA
diligent_noun	aXyavasAyI/pariSramI
dimension_noun	viBA/viswAra/lambAI-cOdAI
diminish_noun	kama_karanA/GatAnA
dinner_noun	rAwri_Bojana/sAnXya_Boja
diploma_noun	diplomA/sanaxa
diplomacy_noun	rAjanayana/kUtanIwi
diplomat_noun	rAjanayika/rAjanayana/kUtanIwijFa
diplomatic_noun	rAjanayika/kUtanIwika
direct_noun	prawyakRa/sIXA/nixeSa_xenA
direction_noun	nixeSa/nixeSana
directive_noun	nixeSa/nixeSAwmaka
director_noun	nixeSaka
directorate_noun	nixeSAlaya
directory_noun	nixeSikA/nirxeSikA
disability_noun	niyogyawA/ni:SakwawA(viXi)/apafgawA
disadvantage_noun	hAni/asuviXA
disagree_noun	asahamawa_honA
disallowed_noun	asvIkqwa
disapprobation_noun	ananumoxana/nApasanxI
disapproval_noun	ananumoxana
disaster_noun	vinASa/vipaxA
disband_noun	woda_xenA/Bafga_karanA
disbursement_noun	saMviwaraNa/bAtanA
discard_noun	alaga_karanA/hatA_xenA
discharge_noun	nirvahana/pAlana/unmocana/sevA-mukwi/kArya-mukwi
discipline_noun	anuSAsana
disclaim_noun	xAvA_CodanA:_svawva_wyAganA/asvIkAra_karanA
disclose_noun	prakata_karanA
disclosure_noun	prakatana
discontent_noun	asanwoRa
discontinuance_noun	samAXAna/samApwi
discontinue_noun	banxa_karanA
discord_noun	visvarawA/anabana
discount_noun	battA
discover_noun	pawA_lagAnA
discredit_noun	aviSvasanIya_mAnanA/sAKa_girAnA
discrepancy_noun	visafgawi
discretion_noun	viveka/svecCAnirNaya
discriminate_noun	viBexa_karanA
discussion_noun	vicAra-vimarSa/carcA_bahasa
disfigure_noun	virUpiwa_karanA
disharmony_noun	asAmaFjasya
dishonest_noun	beImAna
disintegration_noun	viGatana
dislocation_noun	visWApana/aswavyaswa_ho_jAnA
disloyal_noun	niRTAhIna
dismiss_noun	paxacyuwa_karanA/baraKAswa_karanA/KArija_karanA
dismissal_noun	paxacyuwi/baraKAswagI
disobedience_noun	avajFA
disobey_noun	AjFA_na_mAnanA/avajFA_karanA
disorder_noun	avyavasWA/gadabadI/SAnwi_Bafga
disorganise_noun	avyavasWiwa_karanA
disparity_noun	asamAnawA
dispensary_noun	ORaXAlaya/dispensarI
dispenser_noun	ORaXa_viwaraka
disperse_noun	visarjiwa_honA/wiwara-biwara_karanA
displaced_noun	visWApiwa
display_noun	praxarSa/sajAvata/praxarSiwa_karanA
displeasure_noun	aprasAxa/nAKuSI
disposal_noun	nipatAna/nivarwana_vyayana
disposition_noun	pravqfwwa/svaBAva
dispossess_noun	bekabjA_karanA
dispute_noun	vivAxa
disqualification_noun	ayogyawA/anahawA
disqualified_noun	ayogya/anahaZ
disqualify_noun	anahaZ_karanA/anahaZ_honA
disregrad_noun	avahelanA
disrespect_noun	anAxara
dissent_noun	vimawi/visammawi(viXi)/asahamawi
disservice_noun	apakAra
dissociate_noun	niyojiwa_karanA/asambaxXa_honA/alaga_honA
dissolution_noun	Bafga/viGatana
dissolve_noun	viGatiwa_karanA/Bafga_karanA
distinct_noun	fBanna/alaga/suspaRta/suvyakwa
distinction_noun	viBexa/viSeRa_yogyawA
distinctive_noun	viSiRta/pqWaka:_fBanna
distinguish_noun	Bexa_karanA/viSiRtawA_pAnA
distinguished_noun	viSiRta
distortion_noun	vikqwi(viXi)/woda-maroda
distress_noun	vipafwwa/xu:Ka
distribute_noun	viwaraNa_karanA/bAtanA
distribution_noun	viwaraNa/baNtana
distributor_noun	viwaraka/difstrafbyUtara
district_noun	jilA/janapaxa
disturbance_noun	upaxrava/gadabadI/bAXA
ditto_noun	yaWopari/jEse_Upara
diversification_noun	viviXIkaraNa
diversion_noun	viRayAnwara/paWAnwara/paWAnwaraNa
dividend_noun	lABAMSa
division_noun	praBAga/divIjana/viBAjana/SreNI
divorce_noun	walAka/vivAha-vicCexa/walAka_xenA/vivAha-vicCexa_karanA
dock_noun	goxI
docker_noun	goxI_majaxUra
docket_noun	doYketa
docketing_noun	doYketa_banAnA/doYketana
doctor_noun	doYktara/cikiwsaka
document_noun	xaswAveja/praleKa
documentation_noun	praleKIkaraNa/praleKana
domicile_noun	aXivAsa
domiciled_noun	aXivAsI
dominant_noun	praBAvI/prabala
donation_noun	xAna/canxA/sanxAna(viXi)
donor_noun	xAwA/sanxAwA(viXi)
dormitory_noun	SayanaSAlA
dossier_noun	dosiyara
doubtful_noun	sanxigXa
draft_noun	xaswA/tukadI(sEnikoM_kI)/drAPta(bEMka)/prArUpa_masOxA
drafter_noun	prArUpaka
draftsman_noun	1-_prArUpakAra_2-nakSAnavIsa/drAPtsamEna
draw_noun	AharaNa_(vewana_kA)/nikAlanA(lAtarI)/cEka_kAtanA/cEka_liKanA
drawee_noun	axAkarwA
drawer_noun	cEkakarwA/leKIvAla
drawing_noun	drAiMga/reKAciwra/AharaNa
dresser_noun	dresara
driller_noun	fdralara
drive_noun	afBayAna
driver_noun	drAIvara/cAlaka
drought_noun	anAvqfRta/sUKA
druggist_noun	ORaXa_vikrewA
due_noun	xeya/prApya/niyawa
dues_noun	xeya_rASi
duly_noun	viXivawa/yaWAviXi
dummy_noun	damI/nakalI/prawirUpa
dumping_noun	pAtanA
duplicate_noun	xUsarI_prawi/anulipi
duplicating_noun	anulipikaraNa
duplicator_noun	anulipiwra/dufplaketara
duration_noun	avaXi
duress_noun	xabAva
durwan_noun	xaravAna
duty_noun	dyUtI/karwavya-BAra/kArya/kAma/Sulka
dynamic_noun	gawyAwmaka/gawiSIla
earmark_noun	uxaf_xaRta_karanA
earmarked_noun	ke_lie_uxxiRta_(viSeRa_prayojana)
echologist_noun	pArisWiwikIvijFa/parisWiwi-vijFAnI
ecofriendly_noun	paryAvaraNa_hiwERI
ecology_noun	pArisWiwikI
economic_noun	ArWika/arWaSAswrIya/arWakara/lABakara/miwavyayI/kiPAyawI
economical_noun	saswA/miwavyayI/kiPAyawI
economist_noun	arWaSAswrI
economy_noun	arWavyavasWA/miwavyayiwA/kiPAyawa
editing_noun	sampAxana
edition_noun	saMskaraNa
editor-in-chief_noun	pramuKa_sampAxaka
editor_noun	sampAxaka
editorial_noun	sampAxakIya
education_noun	SikRA
educational_noun	SEkRika
educator_noun	SikRaka
effect_noun	praBAva/pariNAma
effective_noun	praBAvI/kAryakArI/vAswavika
effects_noun	cIjabaswa/mAlaBawwA
efficiency_noun	xakRawA/kAryakuSalawA
efficient_noun	xakRa
ejectment_noun	bexaKAlI
elaborate_noun	viswAra_se_kahanA_(kri-)/viSaxa_(vi-)
elapse_noun	bIwanA/bIwa_jAnA
election_noun	nirvAcana
elector_noun	nirvAcaka
electorate_noun	nirvAcaka_maNdala
electrician_noun	bijalI_miswrI
electrification_noun	vixyuwIkaraNa
electroplater_noun	vixyuw-lepaka
elementary_noun	prAraMfBaka
eligibility_noun	pAwrawA
eligible_noun	pAwra
elimination_noun	nikAla_xenA/vilopana
eloquence_noun	vAk-patuwA
embarrass_noun	ulaJana_meM_dAlanA
embarrassment_noun	ulaJana
embassy_noun	rAjaxUwAvAsa
embezzlement_noun	gabana
emblem_noun	samprawIka
emergency_noun	ApAwa/ApAwa_kAla
emergent_noun	ApAwika_/uxgAmI
emigrant_noun	uwpravAsI
emoluments_noun	parilabXiyA
empanelment_noun	nAfBakAyana
employ_noun	niyakuwa_karanA/niyojiwa_karanA/prayoga_karanA/kAma_meM_lAnA
employee_noun	karmacArI
employer_noun	niyokwA
employment_noun	nOkarI/rojagAra/sevAyojana/niyojana/vyavasAya
empower_noun	Sakwi_xenA/aXikAra_xenA
enact_noun	aXiniyama_banAnA/aXiniyamiwa_karanA
enactment_noun	aXiniyamana
encash_noun	BunAnA
encashment_noun	BunAnA/wudAnA
enclave_noun	vixeSI_anwa:/kRewra/enkleva
enclose_noun	banxa_karanA/anulagna_karanA/saMlagna_karanA
enclosure_noun	anulagnaka/bAdA/ahAwA
encroachment_noun	aXikramaNa
encumbrance_noun	villafgama(viXi)/BAra
endorse_noun	pqRTAfkana_karanA/becAna_karanA/sahI_karanA/samarWana_karanA
endorsement_noun	pqRTAfkana/becAna/sahI_samarWana
endowment_noun	vinyAsa(viXi)/Xarmasva/XarmAxA/XarmaxAya/akRaya_niXi
enfacement_noun	muKAfkana
enforce_noun	pravarwana_karanA/pravarwana_karAnA
enforcement_noun	pravarwana
engage_noun	lagAnA/niyakuwa_karanA/vacanabaxXa_karanA/vacanabaxXa_honA
engagement_noun	AbanXa/vacanabanXa_(viXi)
engineer-in-charge_noun	praBArI_iMjIniyara/praBArI_afBayanwA
engineer-in-chief_noun	pramuKa_iMjIniyara
engineer_noun	iMjIniyara/afBayanwA
engraver_noun	ukeraka/uwkIrNaka
enhancement_noun	vqxaf_Xa/baDowarI
enjoin_noun	AxeSa_xenA/vyAxeSa_xenA(viXi)
enlist_noun	BarwIZ_karanA/BarwIZ_honA/nAma_liKanA/sUcI_meM_caDAnA
enquiry_noun	pUCawACa_jAca
enrolment_noun	BarwIZ_nAmAfkana
ensuing_noun	AgAmI
ensure_noun	ASvaswa_karanA/suniSciwa_karanA
enter_noun	xarja_karanA/pravifRta_karanA/kAryaBAra_samBAlanA/kAryaBAra_grahaNa_karanA
enterprise_noun	uxyama
entertain_noun	manoraFjana_karanA_/sawkAra_karanA_/grahaNa_karanA
entertainment_noun	manoraFjana
entitle_noun	hakaxAra_honA/hakaxAra_banAnA
entitled_noun	hakaxAra
entitlement_noun	hakaxArI
entomologist_noun	kItavijFAnI
entrance_noun	praveSa_/praveSa_xvAra
entrant_noun	praveSI
entrepreneur_noun	uxyamI/uxyamakarwA
entry_noun	pravifRta/iMxarAja_praveSa
enumeration_noun	gaNanA/ginanA
environment_noun	paryAvaraNa
envoy_noun	xUwa
epidemic_noun	mahAmArI/jAnapaxika
epidemiologist_noun	mahAmArIvix/jAnapaxikarogavijFAnI
epigraphist_noun	purAleKavewwA
epitome_noun	niRkarRa/sAra
equality_noun	samawA
equilibrium_noun	sanwulana
equipment_noun	upaskara
equitable_noun	sAmyayukwa
equity_noun	sAmyA_iMkvatI
equivalent_noun	paryAya_/samakakRa_/wulyAfka_/wulya/wulyamAna
equivocal_noun	xvayarWaka
eradicate_noun	unmUlana_karanA
eradication_noun	unmUlana
errata_noun	SaxfXa-pawra
error_noun	wruti/BUla/galawI
escort_noun	anurakRaka
essential_noun	anivArya
establishment_noun	sWApanA
estate_noun	sampaxA
estimate_noun	prAkkaWana/anumAna/AkanA/kUwanA_prAkkalana_karanA
estimator_noun	prAkkalaka
ethics_noun	nIwiSAswra/AcAra_nIwi
ethnologist_noun	mAnavajAwivijFAnI
etiquette_noun	SiRtAcAra
evacuation_noun	niRkramaNa
evacuee_noun	niRkrAnwa
evade_noun	tAlanA_/apavaFcana_karanA_(viXi)
evaluation_noun	mUlyAfkana
eviction_noun	bexaKalI
evidence_noun	sAkya/gavAhI/pramANa
evolve_noun	vikasiwa_karanA_(Sabxa)_nirmANa_karanA
ex-india_noun	BArawa_se_bAhara/BArawa-bAhaya
ex-officio_noun	paxena
ex-parte_noun	ekapakRIya
ex-president_noun	1-_BUwapUrva_rARtrapawi_2-_BUwapUrva_aXyakRa/BUwapUrva_saBApawi
ex_noun	pUrva
exact_noun	yaWArWa/bilkula_TIka/niSciwa
examination_noun	parIkRA/parIkRaNa
examiner_noun	parIkRaka
example_noun	uxAharaNa
excavation_noun	uwKanana
excavator_noun	uwKanaka
exccution_noun	niRpAxana
excellence_noun	uwkqRtawA
excellent_noun	uwkqRta
exception_noun	apavAxa
exceptional_noun	viSiRta/apavAxAwmaka
excess_noun	awi/aXikawA/jyAxawI
exchange_noun	vinimaya_keMxra
exchequer_noun	rAjakoRa
excise_noun	uwpAxa_Sulka/AbakArI
exclude_noun	varjiwa_karanA/nikAlanA/apavarjana_(viXi)
exclusion_noun	apavarjana
exclusive_noun	ananya
exclusively_noun	ananya_rUpa_se
excuse_noun	mAPa_karanA/kRamA_karanA/bahAnA
execute_noun	niRpAxana_karanA
executive_noun	kAryapAlikA/kAryapAlaka/aXiSAsI/kAryakAriNI
executives_noun	aXikArI_varga/ekjIkyUtiva
executor_noun	niRpAxaka
exempt_noun	CUta-prApwa/CUta_xenA
exemption_noun	CUta/mAPI
exercise_noun	prayoga/prayoga_karanA/aByAsa/prayAsa
exhaust_noun	ni:SeRa_karanA
exhaustive_noun	sarvAfgapUrNa
exhibit_noun	praxarSa/praxarSiwa_karanA
exhibition_noun	praxarSanI/numAiSa
exigency_noun	wAwkAlika_AvaSyakawA
exit_noun	nirgama/nikAsa/nikAsa_xvAra/nirgama_xvAra
exonerate_noun	Aropa-mukwa_karanA
expansion_noun	viswAra/prasAra/prasaraNa
expatriation_noun	xeSa-nikAlA/xeSa_niRkAsana/xeSa-wyAga/rARtrIyawA-wyAga
expediency_noun	samIcInawA
expedient_noun	samIcIna
expedite_noun	SIGra_kAravAI_karanA/SIGra_nipatAna
expedition_noun	KojayAwrA
expel_noun	nikAla_xenA/niRkAsiwa_karanA
expenditure_noun	vyaya/Karca
experience_noun	anuBava
experiment_noun	prayoga/parIkRaNa
experimental_noun	prAyogika/prayogAwmaka
expert_noun	viSeRajFa
expiry_noun	samApwi
explanation_noun	vyAKyA/spaRtIkaraNa
explicit_noun	spaRta
exploitation_noun	SoRaNa/samupayoga/xohana
explore_noun	Koja_karanA/pawA_lagAnA
explosion_noun	visPota
exponent_noun	prawipAxaka
export_noun	niryAwa
exporter_noun	niryAwaka
express_noun	eksapresa/wuranwa/afBavyakwa/vyakwa_karanA/prakata_karanA/afBavyakwa_karanA
expression_noun	afBavyakwi/vAkyAMSa/paxa
expulsion_noun	niRkAsana/nikAla_xenA/bahiRkaraNa
expunction_noun	hatA_xenA/nikAla_xenA
expunge_noun	nikAlanA
extend_noun	baDAnA/viswAra_karanA
extension_noun	viswAra
extensive_noun	vyApaka/viswqwa
extent_noun	viswAra/sImA
external_noun	bAhaya_vExeSika/vixeSa
extortion_noun	uxxApana/EMTanA(Xana)
extra-curricular_noun	pATayewara/paDAI_ke_awirikwa
extra_noun	awirikwa
extract_noun	uxXaraNa
extraordinary_noun	asAXAraNa
extravagant_noun	PLjUlaKarca/apavyayI_awyaXika
extremist_noun	ugravAxI_awivAxI
extrovert_noun	bahirmuKI
facilitate_noun	sarala_banAnA/sukara_banAnA
facility_noun	suviXA
facsimile_noun	anulipi/prawikqwi
fact_noun	waWya
factionalism_noun	gutabanxI/gutavAxa
factory_noun	kAraKAnA/PEktarI
factual_noun	waWyapUrNa/waWyAwmaka
faculty_noun	safkAya
fail_noun	asaPala_honA/cUkanA/anuwwIrNa_honA/xivAliyA_ho_jAnA
fair_noun	svacCa_uciwa/niRkapata/niRpakRa/paryApwa/sAXAraNa_melA
fairness_noun	Ociwya/nyAyasafgawi
faith_noun	viSvAsa/niRTA/AsWA
faithful_noun	viSvAsapAwra
fake_noun	nakalI/jAlI/managaDanwa
false_noun	miWyA/JUTA
family_noun	parivAra/kutumba
famine_noun	xufBakRa/akAla
farash_noun	ParASa
fare_noun	kirAyA
farewell_noun	vixAI
farming_noun	KewI/kqfRa
fault_noun	xoRa/cUka
faultless_noun	xoRarahiwa
faulty_noun	xoRapUrNa/saxoRa
favour_noun	anugraha/kqpA/pakRapAwa
favourable_noun	anukUla
favouritism_noun	pakRapAwa
feasibility_noun	sAXyawA
federation_noun	parisafGa
fee_noun	Sulka/PIsa
feeling_noun	BAva/anuBUwi/BAvanA/saMvexana
felicitate_noun	baXAI_xenA
fellow_noun	sAWI/aXyewA/rawna_saxasya
fellowship_noun	aXyewAvqfwwa
female_noun	swrI/nArI/mahilA
fertile_noun	upajAU/urvara
fictitious_noun	ParjI/kalpiwa
fidelity_noun	niRTA/vaPAxArI
field_noun	kRewra
figure_noun	afka_Akqwi
figures_noun	Akade
file_noun	misila/PAila/saFcikA/PAila_karanA/xAKLla_karanA
filing_noun	misilabanxI/PAila_karanA
film_noun	Paflma/calaciwra
final_noun	anwima
finalise_noun	anwima_rUpa_xenA
finance_noun	viwwa/rUpayA_lagAnA
financed_noun	viwwapofRawa
financial_noun	viwwIya/viwwa_sambanXI
financier_noun	viwwapoRaka
findings_noun	niRkarRa
fine_noun	xaNda/jurmAnA
fire_noun	Aga_PAyara/golAbArI
fireman_noun	PAyaramEna
fireproof_noun	agnisaha
firing_noun	golIkANda/golI_calAnA/golI_calanA
firm_noun	Parma/vyavasAya-prawiRTAna
fiscal_noun	rAjakoRIya
fisheries_noun	maCalI_pAlana/maCalI_uxyoga/maCalI_kRewra
fit_noun	yogya/upayukwa
fitness_noun	upayakuwawA/yogyawA/Arogya/svasWawA
fitter_noun	PLtara
fix_noun	niyawa_karanA/nirXAriwa_karanA/niSciwa_karanA/sWira_karanA
fixation_noun	niyawana/nirXAraNa
fixed_noun	sWira/baxXa/niSciwa/niyawa
fixtures_noun	judanAra
flag_noun	pawAkA/Xvaja
flagman_noun	JaNdIvAlA
flap_noun	pattI/PlEpa
flat_noun	PlEta
fleet_noun	bedA
flexibility_noun	lacIlApana
flight_noun	PlAita/udAna
floor_noun	saxana/maFca/ParSa/wala/maFjLla
floriculturist_noun	puRpavijFAnI
fluctuation_noun	uccAvacana/Gata-baDa/uwAra-caDAva
foeticide_noun	gaBanASI/gaBanASa
folder_noun	Poldara/cOpannA
folio_noun	Poliyo/pannA
follow-up_noun	anuvarwana
follow_noun	anusaraNa_karanA/pICA_karanA/pAlana_karanA/samaJanA
following_noun	nimnaliKiwa/nIce_liKA/nIce_xiyA_anugAmI
foodgrains_noun	KAxyAnna
forbid_noun	niReXa_karanA
forecast_noun	prAgukwi/pUrvAnumAna
forecaster_noun	pUrvAnumAnakarwA
foregoing_noun	pUrvagawa/pUrvavarwIZ
foreign_noun	vixeSI/bAhaya
foreman_noun	PoramEna
forenoon_noun	pUrvAhana/xopahara_se_pahale
foresight_noun	xUraxarSiwA
forester_noun	vana_xarogA
foreword_noun	prAkkaWana
forfeit_noun	Ko_xenA/jabwa_karanA/samapaharaNa_karanA_(viXi)
forfeiture_noun	jabwI/samapaharaNa
forged_noun	kUtaraciwa/jAlI
forgerer_noun	jAlasAja
forgery_noun	jAlasAjI/kUtaracanA
form_noun	PoYrma/prapawra_rUpa
formal_noun	OpacArika
formality_noun	OpacArikawA
format_noun	ArUpa/PArmeta
formation_noun	nirmANa/racanA
former_noun	pahalA/pUrva/pUrvavarwIZ
formula_noun	sUwra
formulate_noun	banAnA/rUpa_xenA
forthcoming_noun	AgAmI
forthwith_noun	wawkAla
fortnight_noun	pakRa/paKavAdA
fortnightly_noun	pAkRika
forum_noun	maFca/Porama
forward_noun	agravarwIZ/agrefRawa_karanA
foundation_noun	nIMva/AXAra_saMsWApana
founder_noun	saMsWApaka
fraction_noun	KaNda/aMSa_fBanna
framework_noun	DAcA
franchise_noun	mawAXikAra/nAmAXikAra
fraud_noun	kapata/Cala
fraudulent_noun	kapatapUrNa
free_noun	ni:Sulka/alagna/mukwa/svawanwra
freehold_noun	pUrNa_svAmiwva
freelance_noun	svacCanxa
freight_noun	BAdA/mAla
frequency_noun	Avqfwwa/bArambArawA
frequent_noun	bArambAra
from_noun	preRaka
fuel_noun	IMXana
fumigator_noun	XUmaka
function_noun	prakArya/kqwya_samAroha
functional_noun	prayojanamUlaka/prakAryAwmaka
functionary_noun	kAryakarwA
fund_noun	niXi
furlough_noun	PaloZ
furnaceman_noun	BattIvAlA
furnish_noun	xenA_sajjiwa_karanA/sajAnA
gallery_noun	xIGAZ/gElarI/vIWi
galyaniser_noun	jaswakAra/gElvenAijara
games_noun	Kela
gasman_noun	gEsavAlA
gateman_noun	xvArapAla
gathering_noun	jamAva/janasamUha
gazette_noun	rAjapawra/gajata
gazetted_noun	rAjapawriwa
gazetteer_noun	gajetiyara
general_noun	sAXAraNa/sAmAnya_Ama/sArvajanika/janarala/praXAna/mahA
generation_noun	pIDI/janana/uwpAxana
geneticist_noun	AnuvaMSika_vijFAnI/AnuvaMSikIvix
genius_noun	prawiBA/prawiBASAlI/prakqwi
genuine_noun	prAmANika_yaWArWa/vAswavika/saccA/asalI_viSuAxXa
geo-chemist_noun	BU-rasAyanajFa
geochemist_noun	BUrasAyanajFa
geohydrologist_noun	BUjalavijFAnI
geologist_noun	BUvijFAnI
geophysicist_noun	BUBOwikIvix
gift_noun	upahAra/BeMta
gist_noun	sAra
glaring_noun	suspaRta
glazier_noun	kAcaka/SISAgara
glossary_noun	SabxAvalI/Sabxa-safgraha
goal_noun	lakya
godown_noun	goxAma
good_noun	acCA
goodwill_noun	sunAma_saxBAvanA/saxicCA
govern_noun	SAsana_karanA/niyanwraNa_raKanA
governance_noun	SAsana
government_noun	sarakAra/SAsana
governor_noun	1-_rAjyapAla_2-_gavarnara
grace_noun	anugraha/kqpA/riyAyawa
gradation_noun	SreNIkaraNa/paxakrama
grade_noun	paxakrama/greda/SreNI
grader_noun	gredara/SreNI-nirXAraka
gradewise_noun	gredavAra
gradual_noun	kramika
graduate_noun	snAwaka
graft_noun	GUsa/riSvawa/anuciwa_lABa
grafter_noun	kalamakAra
grant-in-aid_noun	sahAyawA_anuxAna
grant_noun	anuxAna:_svIkAra_karanA/praxAna_karanA
granted_noun	svIkqwa
grantee_noun	anuxAnagrAhI/anuxAna_pAne_vAlA
granter_noun	anuxAwA
graph_noun	grAPa/AleKa/leKAciwra
grateful_noun	kqwajFa/ABArI
gratification_noun	pariwoRaNa
gratis_noun	ni:Sulka/muPwa
gratuity_noun	upaxAna
gratutions_noun	Anugrahika/muPwa
grave_noun	gamBIra/safgIna
greetings_)_noun	SuBakAmanA/baXAI/afBavAxana
grievance_noun	SikAyawa
grievous_noun	Gora/gamBIra
gross_noun	sakala/kula/Gora/BArI
groundless_noun	nirAXAra
group_noun	samUha/grupa/varga/yUWa/xala/tolI
groupwise_noun	samUhavAra
guarantee_noun	gAraNtI/prawyABUwi
guaranteed_noun	gAraNtiwa/prawyABUwa
guarantor_noun	gAraNtIkarwA/prawyABUwixAwA
guard_noun	gArda/rakRaka/1-_rakRaka/gAraxa_2-_gArda
guardian_noun	afBaBAvaka
guidance_noun	mArgaxarSana/nirxeSana
guide_noun	gAida/mArgaxarSaka(vyakwi)/mArgaxarSikA_(puswaka)
guidelines_noun	mArgaxarSIZ_sixXAnwa
guilt_noun	aparAXa/xoRa
guiltless_noun	niraparAXa
guilty_noun	xoRI
gummer_noun	goMxavAlA
gunman_noun	ganavAlA/ganamEna
gunner_noun	wopacI/ganara
gynaecologist_noun	swrIroga_vijFAnI
habit_noun	svaBAva/Axawa/aByAsa
habitual_noun	AxI/aByaswa
hall_noun	hoYla/Bavana
halt_noun	virAma
hammerman_noun	haWodevAlA/haWOdLyA
hand-over_noun	sOMpanA/xenA
hand_noun	karmacArI_haswaleKa/liKAvata
handbill_noun	paracA/iSwahAra
handbook_noun	puswikA/gutakA
handcuff_noun	haWakadI
handicap_noun	bAXA
handicapped_noun	vikalAfga/bAXAgraswa
handicraft_noun	xaswakArI/haswakalA/haswaSilpa
handle_noun	xaswA/mUTa/hawWA/samBAlanA
handloom_noun	haWakaraGA
handy_noun	CotA_sA_suviXAjanaka
harassment_noun	pareSAnI/uwpIdana
harbour_noun	banxaragAha
hardware_noun	yanwrasAmagrI/hArdaveyara
haulage_noun	DulAI/DulAI_Karca
havildar_noun	havalaxAra
hazard_noun	joKima
hazardous_noun	joKimavAlA/joKimI
head_noun	praXAna/SIRa_/maxa
heading_noun	SIrRaka
headquarters_noun	muKyAlaya/hedakvArtarsa
hearing_noun	sunavAI
hearsay_noun	sunI-sunAI/anuSruwi
heir_noun	vArisa
heirarchy_noun	uwkrama/sopAna/XarmasawwA
heirless_noun	lAvArisa/uwwarAXikAravihIna
helipad_noun	helipEda
helminthiasist_noun	kqmiroga_vijFAnI
helper_noun	maxaxagAra
herbicide_noun	SAkanASI
hereafter_noun	isake_bAxa/isake_paScAwa
hereby_noun	isake_xvArA/ewaxxvArA
hereditary_noun	pEwqka/mOrUsI/AnuvaMSika
hereinbefore_noun	isameM_isase_pahale/isameM_isase_pUrva
hereunder_noun	isake_nIce/ewaxaXIna
herewith_noun	isake_sAWa
heritage_noun	xAya/virAsawa
high-handedness_noun	manamAnI/jyAxawI
highlighter_noun	ujAgarI
highlights_noun	muKya_bAweM/pramuKa_AkarRaNa/muKya_viSeRawAe
highway_noun	rAjamArga/mahAmArga
hindrance_noun	bAXA/adacana
hire_noun	BAdA/BAde_para_lenA
histopathologist_noun	Uwaka_vikqwi_vijFAnI
history_noun	iwihAsa
hoarding_noun	jamAKorI/vijFApana_patta
holding_noun	jowa_Xqwi
holdoffice_)_noun	(paxa)_grahaNa_karanA
holiday_noun	avakASa/CuttI
holograph_noun	svaleKa
homage_noun	SraxXAFjali
home_noun	gqha
homicide_noun	mAnavavaXa
honest_noun	ImAnaxAra
honorarium_noun	mAnaxeya
honorary_noun	mAnaxa/avEwanika
honour_noun	sammAna:_sammAna_karanA/prawiRTA_sakAranA
honourable_noun	mAnanIya_sammAnapUrNa
honours_noun	prawiRTA/sammAna/oYnarsa_(SikRA)
horticultur_noun	bAgabAnI
horticulturist_noun	uxyAna_viSeRajFa
hospitality_noun	AwiWya/sawkAra
host_noun	AwiWeya/mejabAna
hostel_noun	CAwrAvAsa/AvAsa
hostess_noun	sawkAriNI
hostile_noun	viroXI/SawruwApUrNa/Sawru_kA/Sawru
hours-employment_noun	kAma_ke_GaNte
house-rent_noun	makAna_kirAyA
housing_noun	AvAsana
humane_noun	mAnavociwa/sahqxaya/xayAlu
humiliations_noun	apamAna/anAxara
hutment_noun	asWAyI_imArawa
hydrogeologist_noun	jalaBU-vijFAnI
hydrometeorologist_noun	jala_mOsamavijFAnI
hygiene_noun	svAsWyavijFAna/svacCawA/svAsWya
hypothecation_noun	mAlabanXana/AdamAna(viXi)
identical_noun	eka_jEsA/eka-sA/samarUpa/samAna/waxrUpa
identification_noun	pahacAna/SinAKwa
identity_noun	pahacAna
ignorance_noun	anafBajFawA
ignore_noun	upekRA_karanA/najaraanxAja_karanA
ill-treatment_noun	xuvryavahAra
ill-will_noun	vEmanasya
illegal_noun	avEXa
illicit_noun	nifRaxXa_avEXa
illigible_noun	apATaya
illigimate_noun	avEXa_aXarmaja
illiteracy_noun	nirakRarawA
illogical_noun	warkahIna
illustrated_noun	saciwra_soxAharaNa
illustration_noun	ciwra_uxAharaNa
image_noun	prawiBA_prawibiMba/CAyA_/Cavi
imbalance_noun	asanwulana
immaterial_noun	wawvahIna/sArahIna
immature_noun	bacakAnA/aparipakva
immediate_noun	wawkAla/avilamba/avyavahiwa/Asanna
immigrant_noun	ApravAsI
imminent_noun	Asanna
immoral_noun	anEwika
immovable_noun	sWAvara/acala
immune_noun	unmukwa_/prawirakRiwa
impact_noun	praBAva/samAGAwa_(viXi)
impartial_noun	niRpakRa
impartiality_noun	niRpakRawA
impeachment_noun	mahAfBayoga
impediment_noun	adacana/bAXA
impending_noun	Asanna
imperative_noun	lAjLmI/anivArya
impersonation_noun	CaxmarUpaNa/prawirUpaNa
implecation_noun	vivakRA/nihiwArWa
implement_noun	OjAra/paripAlana_karanA/kAryAfnvawa_karanA/lAgU_karanA
implementation_noun	paripAlana/kAryAnvayana
implicate_noun	PAsanA/PasAnA
implicite_noun	nihiwa
implied_noun	vivakRiwa
import_noun	AyAwa/afBaprAya
important_noun	mahawvapUrNa/AvaSyaka
importer_noun	AyAwaka
impose_noun	aXiropiwa_karanA
imposition_noun	aXiropaNa
impost_noun	mahasUla
impound_noun	paribaxXa_karanA
impracticible_noun	avyAvahArika
impression_noun	CApa/mana_para_praBAva
impressive_noun	praBAvowpAxaka
imprest_noun	agraxAya
imprisonment_noun	kArAvAsa
improper_noun	anuciwa
improve_noun	suXAra_karanA/suXAranA/samunnawa_karanA
improvement_noun	suXAra/saMSoXana/samunnawi/afBavqxfXa_(viXi)
improvisation_noun	kAmacalAU_vyavasWA/wAwkAlika_vyavasWA
improvise_noun	kAma_calAnA/wAwkAlika_vyavasWA_karanA
imputation_noun	aByAropaNa/lAFCana
impute_noun	aByAropiwa_karanA/lAFCana_lagAnA
inability_noun	ayogyawA/asamarWawA
inaccessible_noun	pahuca_se_pare/agamya
inadmissible_noun	asvIkArya/agrAhaya
inadvertence_noun	anavaXAnawA
inadvertently_noun	anajAne/asAvaXAnI_se
inapplicable_noun	aprayojya
incentive_noun	prowsAhana
incidental_noun	AnuRafgika/prAsafgika
incite_noun	BadakAnA/ukasAnA/uxxIpwa_karanA_(viXi)
incitement_noun	uxxIpana/ukasAva
inclination_noun	pravqfwwa/rUJAna/JukAva
inclusion_noun	samAveSa/safmmalana(viXi)
inclusive_noun	sahiwa
incognito_noun	ajFAwa/gupwa_rUpa_se
incoherent_noun	asambaxXa
income_noun	Aya
incoming_noun	Avaka/AganwA
incompatible_noun	bemela
incompetency_noun	akRamawA
incompetent_noun	akRama
incomplete_noun	aXUrA
inconclusive_noun	anirNIwa
incongruous_noun	asafgawa/bewukA
inconsistency_noun	asafgawi
inconsistent_noun	asafgawa
inconvenience_noun	asuviXA
inconvenient_noun	asuviXAjanaka
incorporated_noun	samAviRta/safmmilawa/nigamiwa
incredible_noun	aviSvasanIya
increment_noun	vewana-vqxfXa
incriminate_noun	aparAXa_meM_PasAnA
incumbent_noun	paxaXArI/paxasWa
incumbrance_noun	villafgama_(viXi)/BAra
indemnification_noun	kRawipUraNa
indemnify_noun	kRawipUrwi_karanA
indent_noun	mAga-pawra/iMdeMta
indentor_noun	mAgakarwA
indenture_noun	vileKa/xaswAveja
independent_noun	svawanwra
index_noun	anukramaNikA/anukramaNI/sUcaka
indexer_noun	anukramaNIkAra/indeksara
indexing_noun	sUcI_banAnA/anukramaNI_banAnA
indication_noun	safkewa_sUcanA
indicator_noun	safkewaka
indict_noun	aByAropiwa_karanA/ilajAma_lagAnA
indifference_noun	uxAsInawA
indirect_noun	parokRa/aprawyakRa
indiscipline_noun	anuSAsanahInawA
indiscretion_noun	aviveka
indiscriminate_noun	avivekI/avicArapUrNa/anXAXunXa
indispensable_noun	aparihArya
indisputable_noun	nirvivAxa
indistinct_noun	aspaRta
individual_noun	vyakwi/vyafRta/vEyakwika/vyakwigawa
individually_noun	alaga-alaga/vyakwiSa:
indorsement_noun	pqRTAfkana/becAna
industrialist_noun	uxyogapawi
industrialization_noun	uxyogIkaraNa/OxyogIkaraNa
industrious_noun	aXyavasAyI
industry_noun	uxyoga
ineffective_noun	niRpraBAvI/apraBAvI
inefficiency_noun	axakRawA
inefficient_noun	axakRa
ineligibility_noun	apAwrawA
ineligible_noun	apAwra
inevitable_noun	avaSyamBAvI/aparihArya
inexpedient_noun	asamIcIna
infanticide_noun	SiSuhawyA
infection_noun	safkramaNa
inference_noun	anumiwi/anumAna
inferior_noun	nimna/avara
inferiority_noun	hInawA
infiltrate_noun	gupwa_praveSa/GusapETa
infirmity_noun	aSakwawA/xOrbalya
inflation_noun	sPIwi/muxrAsPIwi
influential_noun	praBAvaSAlI
informal_noun	anOpacArika
information_noun	sUcanA
infrastructure_noun	AXArika_saMracanA
infringe_noun	awilafGana_karanA_(viXi)/ullafGana_karanA
infringement_noun	awilafGana
inherent_noun	anwanihiwa_sahaja
inherit_noun	virAsawa_meM_pAnA
inheritance_noun	virAsawa/uwwarAXikAra/vaMSAgawi
initial_noun	prAraMfBaka
initials_noun	AxyakRara
initiate_noun	prAramBa_karanA/upakramaNa/pahala_karanA
initiative_noun	pahala_Sawi/sUwrapAwa-kRamawA/pahala
injuction_noun	vyAxeSa
inland_noun	anwarxeSIya_/anwa:sWalIya_(jEse_jalamArga)
inoculation_noun	tIkA/tIkA_lagAnA
inoculator_noun	tIkA_lagAne_vAlA
inoperative_noun	apravqwwa
inordinate_noun	awyaXika
inquiry_noun	pUCawACa_jAca
insecticide_noun	kItanASI
insert_noun	anwa:sWApiwa_karanA/meM_raKanA
insight_noun	anwaxqfRta
insignia_noun	aXicihna
insignificance_noun	mahawvahInawA/wucCawA
insolvency_noun	xivAlA/xivAliyApana
inspect_noun	nirIkRaNa_karanA
inspection_noun	nirIkRaNa
inspector_noun	nirIkRaka
inspectorate_noun	nirIkRaNAlaya
instability_noun	asWirawA
installation_noun	saMsWApana/aXiRTApana
instalment_noun	kLswa
instigate_noun	ukasAnA
instigation_noun	ukasAhata
institute_noun	saMsWAna/saMsWA/saMsWApiwa_karanA/sWApiwa_karanA/calAnA/prAramBa_karanA
institution_noun	saMsWA
instruction_noun	anuxeSa/hixAyawa
instructor_noun	anuxeSaka
instrument_noun	yanwra_(liKawa_/prapawra
instrumentalist_noun	vAxaka/yanwra-vAxaka
insubordination_noun	anaXInawA
insurance_noun	bImA
insure_noun	bImA_karanA
insured_noun	bImA_kiyA_huA/bImAkqwa
integral_noun	afBanna/aviBAjya
integration_noun	ekIkaraNa/samAkalana/aKaNdawA
integrity_noun	sawyaniRTA/ImAnaxArI/aKaNdawA
intelligence_noun	AsUcanA
intelligible_noun	boXagamya
intemperance_noun	asaMyama
intensive_noun	gahana/prakqRta/wIvra
intent_noun	ASaya
intention_noun	afBaprAya/ASaya
intentionally_noun	sAfBaprAya/sASaya
inter-communication_noun	anwarAsaFcAra
inter-departmental_noun	anwarAviBAgIya
inter-unit_noun	anwarA_ekaka
interception_noun	anwaragrahaNa/roka_lenA/anwarAvaroXana
interest_noun	byAja_(hiwa
interfere_noun	haswakRepa_karanA
interference_noun	haswakRepa
interim_noun	anwarima
intermediary_noun	maXyavarwIZ/maXyaga
intermediate_noun	maXyavarwIZ/iMtara_pAsa_(vyakwi)
internal_noun	Anwarika/AByanwarika
interpolation_noun	prakRepa_(pATa)/anwaraveRaNa_(Akade)
interpretation_noun	nirvacana/vyAKyA
interpreter_noun	xuBAfRayA/BARAnwarakAra
interrogate_noun	pUCawACa_karanA/paripraSna_karanA
interrogation_noun	paripraSna/pUCawACa
interrogator_noun	paripraSnaka
interrupt_noun	bAXA_dAlanA/tokanA
interruption_noun	bAXA/viGna/vyavaXAna/kramaBafga
interval_noun	anwarAvaXi/anwarAla
intervene_noun	bIca_meM_padanA/anwa:kRepa_karanA/xaKala_xenA
intervention_noun	anwa:kRepa/bIca_meM_padanA
interview_noun	sAkRAwkAra/BeMta/iMtaravyU/BeMtavArwA
intimate_noun	sUcanA_xenA/prajFApiwa_karanA(viXi)
intimation_noun	prajFApana/sUcanA/ifwwalA
intimidation_noun	afBawrAsa/darAnA-XamakAnA
intolerance_noun	asahanaSIlawA/asahiRNuwA
intoxication_noun	mAxakawA/naSA/mawwawA
intricacy_noun	jatilawA
intricate_noun	jatila
intrigue_noun	kucakra/sAjLSa
introduce_noun	praswuwa_karanA/paricaya_karAnA/samAviRta_karanA
introduction_noun	praswAvanA/paricaya/pura:sWApanA
invalid_noun	aviXimAnya/amAnya/aSakwa
invalidation_noun	amAnyakaraNa
invalidity_noun	asamarWawA/aSakwawA
inventory_noun	vaswusUcI/Pehariswa/inaveMtarI
investigation_noun	anveRaNa/waPawISa/jAca-padawAla
investigator_noun	anveRaka
investment_noun	niveSa/viniXAna(viXi)
invigilation_noun	anvIkRaNa
invigilator_noun	nirIkRaka
invitation_noun	nimanwraNa/AmanwraNa
invoice_noun	bIjaka
involuntary_noun	anEcCika
involved_noun	anwanihiwa/PasA_huA/sambaxXa/anwagraswa/graswa
irrational_noun	ayukwa/avivekaSIla/warkahIna
irrecoverable_noun	lAvasUla/avasUlIya
irrelevant_noun	asambaxXa/asafgawa
irresponsible_noun	anuwwaraxAyI/gErajafmmexAra
irrevocable_noun	atala
irrigular_noun	aniyamiwa
issue_noun	nirgama/jArI_karanA/BejanA/xenA_muxxA/vAxa-paxa(viXi)/sanwAna_afka(pawrikA)
item_noun	maxxa/maxa
itemwise_noun	maxavAra
itinerary_noun	yAwrAkrama
jail_noun	jela/banxIgqha
jailor_noun	jelara
jamadar_noun	jamAxAra
jetty_noun	GAta/jetI
job_noun	nOkarI/joYba_(kArya
join_noun	kAryaBAra_grahaNa_karanA/nOkarI_SurU_karanA/safmmaliwa_honA/saMyojiwa_karanA
joint_noun	saMyukwa
jointly_noun	saMyukwa_rUpa_se
journal_noun	xEnikI/rojanAmacA/pawrikA/jaranala
journalist_noun	pawrakAra
journeyman_noun	jarnImEna
jubilee_noun	jayanwI
judge_noun	nyAyAXISa
judgement_noun	nirNaya
judicial_noun	nyAyika/axAlawI
judiciary_noun	nyAyapAlikA
judicious_noun	vivekasammawa
juniority_noun	kaniRTawA
jurisdiction_noun	aXikAra_kRewra/kRewrAXikAra/aXikAriwA
jurist_noun	viXiSAswrI
jury_noun	jUrI
just_noun	nyAya/uciwa/TIka
justice_noun	nyAya_(nyAyamUrwi/nyAyamUrwi/nyAyAXipawi
justiciable_noun	vAxayogya
justifiable_noun	nyAyociwa/samarWanIya
justification_noun	warkasafgawi/Ociwya
justify_noun	nyAyociwa_TaharAnA/saPAI_xenA/nyAyasafgawa_sixXa_karanA/uciwa_sixXa_karanA
juvenile_noun	bAla/bAlya/kiSora
key-board_noun	kuFjI_patala/kI_borda
key_noun	AXAraBUwa/mUla_(muKya_(kuFjI
khalasi_noun	KalAsI
kidnapping_noun	vyapaharaNa/agavA
know-how_noun	jAnakArI/wakanIkI_jAnakArI
knowingly_noun	jAnabUJakara
knowledgeable_noun	suvijFa/jAnakAra
lable_noun	lebala
laboratory_noun	prayogaSAlA
labour_noun	Srama_(Sramika_varga
labourer_noun	Sramika/majaxUra
lampman_noun	bawwIvAna
landholder_noun	BUmiXArI
landlord_noun	BU-svAmI/makAna_mAlika
landmark_noun	sImA_cihna
landowner_noun	BU-svAmI
language_noun	BARA
lapse_noun	bIwa_jAnA/vyapagawa_honA_(galawI
lascar_noun	laSkara/KalAsI
lasting_noun	sWAyI
lastly_noun	AKafra_meM/anwawa:
late_noun	vilamba_se/xera_se_(svargIya
latest_noun	aXunAwana/navInawama
latheman_noun	KarAxiyA
latitude_noun	CUta/DIla
laudable_noun	praSaMsanIya
launch_noun	prAramBa_karanA_(pramocana
lavatory_noun	SOcAlaya
law_noun	viXi/kAnUna
lawful_noun	viXisammawa
lawyer_noun	vakIla
laxity_noun	SiWilawA
layoff_noun	kAmabanxI
layout_noun	afBanyAsa/nakaSA
leader_noun	pramuKa/newA/lIdara/agraNI/agraleKa
leaflet_noun	parcIZ
leakage_noun	risana/lIkeja
learning_noun	sIKanA/aXigama/vixvawwA
lease_noun	pattA/patte_para_xenA
leasehold_noun	patte_para/pattAXqwi
leaseholder_noun	pattAXArI/pattexAra
leasing_noun	pattA_uXAra/lIjiMga
leave_noun	CuttI/avakASa/anumawi/CodanA
lecturer_noun	prAXyApaka/lekcarara
ledger_noun	KAwA/KAwA_bahI
legacy_noun	rikWa/vasIyawa-sampaxA_(viXi)
legal_noun	kAnUnI/viXika
legality_noun	vEXawA
legalization_noun	vEXIkaraNa
legalize_noun	vEXa_karanA/vEXa_banAnA
legally_noun	vEXa_rUpa_se/kAnUnI_wOra_para
legate_noun	praNiXi/lIgeta
legation_noun	xUwAvAsa
legible_noun	suvAcya/paDe_jAne_yogya
legislative_noun	vEXAnika_(viXAyI
legislature_noun	viXAnamaNdala
legitimacy_noun	vEXawA/XarmajawA/OciwyapUrNawA
legitimate_noun	uciwa/viXisammawa/viXi-safgawa/Xarmaja
leisure_noun	avakASa/Purasawa
lenicncy_noun	naramI/uxArawA
lessee_noun	pattexAra
letter_noun	pawra
level_noun	swara_(wala
levy_noun	uxagrahaNa/ugAhI
lexicographer_noun	koSakAra
lexicography_noun	koSavijFAna
lexicon_noun	koSa
liability_noun	xAyiwva/xeyawA
liable_noun	xAyI/xenaxAra/jimmexAra/BAgI
liaison_noun	samparka
librarian_noun	puswakAlaya_aXyakRa/lAibreriyana
library_noun	puswakAlaya
licence_noun	anujFapwi/lAiseMsa/svecCAcAra
licensed_noun	anujFApiwa/lAiseMsa-prApwa
licensee_noun	anujFapwiXArI/lAiseMsaXArI
lien_noun	liyana/punagrahaNAXikAra/XAraNAXikAra
lieutenant_noun	lefPtaneMta
lighthouse_noun	prakASaswamBa
lightship_noun	prakASa_powa
limit_noun	haxa/sImA_(parisImA/maryAxA
limitation_noun	sImA_avaXi
limited_noun	sImiwa/limiteda
lineman_noun	lAinamEna
linguist_noun	BARAvix/1-_BARAvijFAnI_2-_bahuBARAvix
link_noun	kadI/SqfKalA/banXa/liMka/samparka/saMlagna/sambaxXa
linkage_noun	sahalagnawA/anubanXana
liquidation_noun	parisamApana/SoXana/nirXAraNa
liquidator_noun	parisamApaka
list_noun	sUcI
literacy_noun	sAkRarawA
literal_noun	SAfbxaka
literate_noun	sAkRara
litigant_noun	vAxakArI/mukaxamebAja
litigation_noun	mukaxamebAjI
livelihood_noun	jIvikA
livestock_noun	paSuXana
loan_noun	karja
loanee_noun	karjaxAra
loaner_noun	lenaxAra
lobby_noun	loYbI
lobbying_noun	pakRa_jutAva
location_noun	sWiwi/avasWiwi
lodging_noun	vAsa
logic_noun	warkaSAswra/warka
logo_noun	logo/prawIka_cihna
lot_noun	Kepa/loYta/DerI
lounge_noun	viSrAnwikA/lAunja
lower_noun	nicalA/nimnawara/avara
loyal_noun	niRTAvAna/vaPAxAra/rAjaniRTa
loyalty_noun	niRTA/vaPAxArI
lunch_noun	maXyAhna-Bojana/laFca
maarshal_noun	mArSala
machine_noun	maSIna/yanwra
machinery_noun	maSInarI_(wanwra/vyavasWA
machinist_noun	maSIna_miswrI
magazine_noun	goxAma/bArUxaGara/AyuXAgAra/pawrikA
magistrate_noun	majistreta
maintain_noun	raKanA/BaraNa-poRaNa_karanA/anurakRaNa_karanA/banAe_raKanA
maintenance_noun	anurakRaNa/raKaraKAva_raKanA/BaraNa-poRaNa
major_noun	vayaska/prApwavaya/muKya/mejara_(paxa)/mejara
majority_noun	bahumawa/vayaskawA/bAligapana/prApwavayawA/bahusafKyaka
maladjustment_noun	kusamAyojana
maladministration_noun	kupraSAsana
malafide_noun	xuBAvapUrNa/kaxASayI/asaxBAvapUrvaka_(viXi)
malafides_noun	baxanIyawI/xuBAva/kaxASaya
malbehaviour_noun	anuciwa_vyavahAra
malice_noun	vixveRa/xuBAva
malicious_noun	vixveRapUrNa/xuBAvapUrNa
malnutrition_noun	kupoRaNa
malpractice_noun	anAcAra
maltreatment_noun	xuvryavahAra
management_noun	prabanXa/prabanXana
manager_noun	prabanXaka/mEnejara/vyavasWApaka
mandate_noun	aXixeSa_AjFA
mandatory_noun	AjFApaka/anivArya/aXixeSAwmaka
manhole_noun	mEnahola
manifesto_noun	GoRaNA-pawra
manipulate_noun	calAnA/joda-woda_karanA
manipulation_noun	haswa-kOSala/joda-woda/CalasAXana(viXi)/prakalana
manoeuvre_noun	xAva-peMca/yukwicAlana
manpower_noun	janaSakwi
manual_noun	puswikA/xIpikA/niyama_puswaka/niyamAvalI/SArIrika/haswa
manufacture_noun	vinirmANa
manufacturer_noun	vinirmAwA
manuscript_noun	pANdulipi/haswaleKa
map_noun	mAnaciwra/nakSA
mapper_noun	nakSAkAra
margin_noun	hASiyA/upAnwa/guFjAiSa
marginal_noun	sImAnwa/upAnwika
mariner_noun	nAvika/jahAjI
mark_noun	cihna
marked_noun	cifhnawa_(ulleKanIya
marker_noun	mArkara_(paxanAma)/cihnaka_(yanwra)/mArkara
marketing_noun	vipaNana
marks_noun	afka
marksheet_noun	afka_sUcI/afkapawra
martyr_noun	huwAwmA/SahIxa
mascot_noun	SuBafkara
mason_noun	rAja/rAjamiswrI
masonry_noun	cinAI/rAjagIrI
mass_noun	janasamUha/sAmUhika/vyApaka
mast_noun	maswUla
master-at-arms_noun	mAstara-Eta-Amrsa
master_noun	aXyApaka/svAmI/mAstara/niRNAwa
masterpiece_noun	awyuwwawama_kqwi/SreRTa_kqwi
mate_noun	meta
materials_noun	sAmagrI/sAmAna
maternity_noun	prasUwi/mAwqwva
matriculate_noun	mEtraki_pAsa
matrimonial_noun	vEvAhika
matron_noun	mEtrana
matter_noun	viRaya/mAmalA
mature_noun	paripakva/prODa/pUrNa_honA/paripakva_honA
maturity_noun	paripakvawA/miyAxa_pUrI_honA/prODawA/pUrNawA
maxim_noun	sUkwi
maximum_noun	aXikawama/jyAxA_se_jyAxA
mayor_noun	mahApOra/meyara
means_noun	sAXana/upAya
measure_noun	mApa
measurement_noun	mApa
measures_noun	upAya_(kAryavAhI
mechanic_noun	mekEnika/miswrI
mechanical_noun	yAnwrika
mechanician_noun	mekEniSiyana
mechanism_noun	wanwra_(kriyAviXi
mechanist_noun	yAnwrika/mekEnista
media_noun	mAXyama
mediation_noun	maXyagawA
mediator_noun	maXyaga
medical_noun	cikiwsA
medicine_noun	AyurvijFAna_xavA
medico-legal_noun	cikiwsA-viXika
medium_noun	mAXyama
meeting_noun	bETaka/saBA/mItiMga
megapolis_noun	bqhannagara/virAtanagara
member_noun	saxasya
membership_noun	saxasyawA
memo_noun	jFApana/memo
memorandum_noun	jFApana
memorial_noun	smAraka/aByAvexana
memorialist_noun	aByAvexaka
menu_noun	menU/Bojya_wAlikA/prasUcI
merchandise_noun	vANijya-vaswu/sOxA/vANijya_(viXi)
merger_noun	vilayana
merit_noun	guNa/yogyawA
meritorious_noun	suyogya/sarAhanIya/praSasya/meXAvI/guNavAna
merits_noun	guNAvaguNa
message_noun	sanxeSa
messenger_noun	sanxeSavAhaka
messman_noun	mesamEna
metallurgist_noun	XAwukarmIZ
meteorologist_noun	mOsamavijFAnI
method_noun	viXi/paxXawi/praNAlI
methodology_noun	kAryapraNAlI/praNAlIvijFAna
microbiologist_noun	sUkmajIva_vijFAnI
microfilm_noun	mAikroPLlma
midshipman_noun	midaSipamEna
midwife_noun	midavAiPa/xAI
midwifery_noun	prasUwi_vixyA
migrant_noun	pravAsI
migration_noun	pravAsa
mileage_noun	mIla-xUrI_(mIla_BawwA
militia_noun	miliSiyA/nAgarika_senA
milker_noun	xohaka
mill_noun	mila_cakkI
millennium_noun	sahas/AAfbxa
mine_noun	KAna/Kani
mineralogist_noun	KanijavijFAnI
miniature_noun	laGu/CotA
minimum_noun	nyUnawama/kama-se-kama
mining_noun	Kanana/Kanikarma
minister_noun	manwrI
ministerial_noun	lipikavargIya/anusacivIya_(viXi)
ministry_noun	manwrAlaya
minor_noun	avayaska/aprApwavaya/nAbAliga/laGu/gONa
minority_noun	alpasafKyA/alpasafKyaka/alpa-safKyaka_varga/alpamawa/avayaskawA
mint_noun	takasAla
minutes_noun	kAryavqwwa/tippaNa
misappropriation_noun	xurviniyojana
misbehaviour_noun	xuvryavahAra
miscellaneous_noun	Putakara/viviXa
mischief_noun	SarArawa/uwpAwa_rifRta_(viXi)
misconduct_noun	kaxAcAra
mislead_noun	gumarAha_karanA/Brama_meM_dAlanA
mismanagement_noun	kuprabanXa
misrepresentation_noun	anyaWA-kaWana
mission_noun	miSana
mistry_noun	miswrI
misuse_noun	xurupayoga/xurupayoga_karanA
mixed_noun	mifSrawa/milAjulA
mob_noun	BIda/asaMyawa_BIda
mobile_noun	cala/calawA-PirawA
mobilization_noun	jutAva
modality_noun	rIwi
mode_noun	Dafga/prakAra/rIwi
model_noun	nixarSa/moYdala/AxarSa
moderation_noun	anuSoXana/saMyamana
moderator_noun	saFcAlaka/maryAxaka
modification_noun	ASoXana/waramIma/rUpAnwara
momentum_noun	saMvega
money_noun	Xana/muxrA
monitor_noun	moYnItara/anuvIkRaNa_karanA/moYnItara_karanA
monitoring_noun	moYnItarana/anuvIkRaNa
monogamy_noun	ekavivAha_(praWA)
monogram_noun	monogrAma/nAmacihna/gumPAkRara
monopoly_noun	ekAXikAra/ekAXipawya
monotony_noun	ekarasawA
monument_noun	smAraka
moral_noun	nEwika
morale_noun	manobala/hOsalA
moratorium_noun	aXisWagana/aXisWagana_kAla
morgue_noun	muxAGara
mortality_noun	mqwyusafKyA/mqwyuxara
mortgage_noun	banXaka/rehana
mortgagee_noun	banXakaxAra
mortgagor_noun	banXakakarwA
mortuary_noun	muxAGara
motel_noun	motela
motion_noun	praswAva
motivation_noun	afBapreraNa
motive_noun	uxxeSya_(afBapraraNA_(hewu
motor_noun	motara
motorman_noun	motaramEna
motto_noun	AxarSavAkya/AxaSokwi
moudler_noun	sAcAgara
mounter_noun	maDAIkAra/mAuNtara
mourning_noun	Soka/mAwama
mouthpiece_noun	muKapawra_(pakRavakwA_(muKikA
movable_noun	cala/jafgama
move_noun	praswAva_raKanA/praswAviwa_karanA
movement_noun	Anxolana/saFcalana/gawiviXi
mover_noun	praswAvaka
multipurpose_noun	bahUxxeSIya/bahuprayojanI
municipal_noun	nagarapAlikA/nagarapAlikA_sambanXI
municipality_noun	nagarapAlikA
muscat_noun	SuBafkara
museum_noun	safgrahAlaya
music_noun	safgIwa
mutation_noun	nAmAnwaraNa/xAKLla-KArija
mutilated_noun	katAPatA/vikqwa
mycologist_noun	kavakavijFAnI
myth_noun	miWaka
narcotic_noun	nArkOtika/svApaka
narrator_noun	nerreItara/varNanakarwA/vAcaka
nation_noun	neISana/rARtra
national_noun	nESanala/rAfRtraka/rARtrIya
nationalism_noun	nESanalijama/rARtrIyawA
nationality_noun	nESanElitI/rAfRtrakawA
nationalization_noun	nESanalAIjeISana/rARtrIyakaraNa
native_noun	neItiva/mUla_nivAsI
natural_noun	nEtyurala/prAkqwika_svABAvika/nEsagika
naturalization_noun	nEtralAIjeISana/xeSIyakaraNa
navigable_noun	nEvigabala/nAvya
navigation_noun	nEvigeISana/nOparivahana/nOcAlana/xik_cAlana
navigator_noun	nEvigeItara/nevIgetara/nOcAlaka
nayes_noun	neIja/nahIM_pakRa
needful_noun	nIdPala/AvaSyaka_kAravAI
negative_noun	negativa/niReXAwmaka
neglect_noun	niglekt/upekRA/lAparavAhI/upekRA_karanA
negligence_noun	neglijens/upekRA/pramAxa/gaPalawa
negligible_noun	neglijabala/nagaNya
negotiability_noun	negoSabilatI/parakrAmyawA
negotiate_noun	negoSIeIta/parakrAmaNa_karanA/bAwacIwa_karanA
negotiation_noun	negoSIeISana/bAwacIwa
nematologist_noun	nematOlajist/sUwrakqmijFa
nepotism_noun	nepatijama/svajana-pakRapAwa/BAI-BawIjAvAxa
net_noun	neta/jAwa_SaxXa/nivala
network_noun	netvark/jAla/jAla-wanwra
neutral_noun	nUtrala/watasWa
neutrality_noun	nUtrElitI/watasWawA
news-reel_noun	nUjrIla/nyUjarIla/samAcAra-xarSana
news_noun	nUja/samAcAra
newspaper_noun	nUjpeIpara/samAcArapawra/aKabAra
nomenclature_noun	nOmenkleIcara/nAmapaxXawi
nominate_noun	nOmineIta/nAmiwa_karanA/nAma_nirxeSana
nominated_noun	nOmineItida/nAmiwa
nomination_noun	nOmineISana/nAma_nirxeSana/nAmana/nAmAfkana
nominee_noun	nOminI/nAmiwI/nAmiwa_vyakwi
non-acceptance_noun	nOna-Ekseptans/asvIkqwi
non-advertised_noun	nOna-EdvartAIjd/avijFApiwa
non-age_noun	nOna-eIja/avayaskawA
non-agricultural_noun	nOna-Egrikalcarala/kqRIwara
non-appearance_noun	nOna-apIrans/peSa_na_honA/gErahAjLrI
non-commercial_noun	nOna-kamarSala/avyApArika/avANifjyaka
non-compliance_noun	nOna-kamplAyansa/apAlana
non-confidential_noun	nOna-kOnPidencala/agopanIya
non-consent_noun	nOna-kansent/asammawi
non-delivery_noun	nOna-dilivarI/aviwaraNa
non-earning_noun	nOna-arnIfa/anarjaka
non-effective_noun	nOna-iPektiva/apraBAvI
non-entitled_noun	nOna-intAItald/gEra-hakaxAra
non-essential_noun	nOna-esinSala/gEra-jarUrI
non-gazetted_noun	nOna-gajetid/arAjapawriwa
non-judicial_noun	nOna-jUdiSala/nyAyikewara
non-ministrial_noun	nOna-ministryala/alipika_vargIya/ananusacIvIya
non-negotiable_noun	nOna-negoSabala/a_parakrAmya
non-observance_noun	nOna-abjarvans/apAlana
non-official_noun	nOna-aPiSala/gEra-sarakArI/aSAsakIya/anaXikArika
non-party_noun	nOna-pArtI/gEra-xalIya
non-payment_noun	nOna-peIment/BugawAna_na_karanA/gEra-axAyagI
non-pensionable_noun	nOna-penSanabala/apeMSanI/gEra-peMSanI
non-plan_noun	nOna-plEna/yojanewara/gEra-yojanA
non-saleable_noun	nOna-seIlabala/avikreya
non-standard_noun	nOna-stEndard/amAnaka
non-statutory_noun	nOna-stEcatrI/asAMviXika/akAnUnI
non-traditional_noun	nOna-tradiSanala/aparamparAgawa/gEraparamparAgawa
non-voted_noun	nOna-votida/axawwamawa
norm_noun	nOrm/prawimAnaka
normal_noun	nOrmala/prasAmAnya
normalization_noun	nOrmalijeISana/sAmAnyIkaraNa
note_noun	nota/tippaNI/xraRtavya
noted_noun	notida/nota_kara_liyA
noter_noun	notara/tippaNI_leKaka/tippaNakAra
notice_noun	notisa/sUcanA
noticeable_noun	notisabala/ulleKanIya/XyAna_xene_yogya
notification_noun	notiPikeISana/aXisUcanA
notorious_noun	notOryasa/kuKyAwa
notwithstanding_noun	nOtviwstEndIfa/ke_hone_para_BI/ke_howe_hue_BI
novice_noun	nOvisa/nOsiKiyA
nucleus_noun	nUklIyasa/nAfBaka/nyUfklayasa
nuisance_noun	nUsans/kaNtaka/nyUseMsa
null_noun	nala/bAwila/akqwa
nullify_noun	naliPAI/bAwila_karanA/akqwa_karanA
number_noun	nambara/safKyA
numbering_noun	nambarIfa/safKyAfkana/safKyA_dAlanA
numeral_noun	nUmarala/safKyAfka/afka
numismatist_noun	nUmijmEtist/muxrAvix
nurse_noun	nars/narsa/paricArikA
nursery_noun	narsarI/pOXaSAlA/SiSu_saxana
nurseryman_noun	narsarImEna/pOXamAlI
nutrition_noun	nUtriSana/poRaNa
nutritionist_noun	nUtriSanist/poRaNavix
oath_noun	SapaWa
obedience_noun	AjFApAlana/AjFAnuvarwana
obituary_noun	niXana-sUcanA
object_noun	vaswu_Apafwwa_uTAnA/Apafwwa_karanA
objection_noun	Apafwwa
objective_noun	uxxeSya/vaswuniRTa/viRayaparaka
objectivity_noun	vaswuniRTawA
obligation_noun	bAXyawA/banXana/xAyiwva/ABAra
obligatory_noun	bAXyakara
obscene_noun	aSlIla
observance_noun	pAlana
observation_noun	prekRaNa_/(tippaNI/samukwi
observer_noun	prekRaka
obsolescence_noun	apracalana
obsolete_noun	apracaliwa
obstetrician_noun	prasUwivijFAnI
obstruction_noun	bAXA
obvious_noun	spaRta
occanographist_noun	samuxravijFAnI
occasional_noun	yaxAkaxA/aniyawa/prAsafgika
occupancy_noun	xaKala/aXiBoga
occupant_noun	xaKalakAra/xaKalIkAra/aXiBogI
occupation_noun	vyavasAya/XanXA
occupy_noun	aXikAra_meM_karanA/xaKala_karanA/sWAna_GeranA
occurrence_noun	GatanA/Gatiwa_honA
offence_noun	aparAXa
offender_noun	aparAXI
offensive_noun	AkramaNAwmaka_afpraya/katu_GqNowpAxaka/baxabUxAra
offer_noun	praswAva
office_noun	kAryAlaya/xaPwara_/(paxa
officer_noun	aXikArI/aPasara
official_noun	paxaXArI_/(SAsakIya/sarakArI
officialdom_noun	aPasaraSAhI
officiate_noun	sWAnApanna_honA/sWAnApanna_rUpa_meM_kAma_karanA
officiating_noun	sWAnApanna
oiler_noun	wela_xene_vAlA
omission_noun	lopa_cUka
oncrous_noun	xuBara/xurvaha
onus_noun	BAra/xAyiwva
operation_noun	pracAlana_/(safkriyA
operative_noun	karmI/pravarwIZ
operator_noun	pracAlaka/oYparetara
opinion_noun	rAya/mawa
opportunity_noun	avasara
opposition_noun	viroXa/viroXI_xala
opthalmologist_noun	newravijFAnI
optician_noun	caSmAsAja
opticist_noun	xqfRtavijFAnI
option_noun	vikalpa
optional_noun	vEkalpika
oral_noun	mOKika/jabAnI
orally_noun	mOKika_rUpa_se
orchardist_noun	PaloAnI
orchestrator_noun	vAxyavqnxakAra
order_noun	AxeSa_/(krama
orderly_noun	arxalI
ordinance_noun	aXyAxeSa
organization_noun	safgaTana_/(vyavasWA/Ayojana
organize_noun	safgaTiwa_karanA/Ayojiwa_karanA
organizer_noun	safgaTanakarwA/Ayojaka
oriental_noun	prAcya
orientation_noun	afBavinyAsa
oriented_noun	unmuKa/afBavinyaswa
original_noun	mUla_prawi/mUla/mOlika/prAraMfBaka
orphanage_noun	anAWAlaya
ostensible_noun	xqSyamAna
outbreak_noun	prakopa_/(vixroha
outgoing_noun	nivarwamAna
outlay_noun	parivyaya
outlet_noun	nikAsa/nirgama/nirgama_keMxra
outline_noun	KAkA/rUpareKA
outlook_noun	xqfRtakoNa
outpost_noun	sImA_cOkI
output_noun	uwpAxana/uwpAxa/nirgawa
outstanding_noun	bakAyA/uwkqRta
outstation_noun	bAhya_sWAna
ovation_noun	afBananxana/svAgawa
over-age_noun	aXivayas
over-population_noun	aXika_janasafKyA/janAXikya_safKyAXikya
over-rule_noun	ulatanA/virUxXa_vyavasWA_xenA
over-work_noun	kAryAXikya
over-writing_noun	aXileKana/liKe_para_liKanA
overall_noun	samaswa/samagra/kula/ovara_Ala
overcharge_noun	aXipraBAra
overcrowding_noun	BIda-BAda/awi_BIda
overdue_noun	awiSoXya_purAnA/KadA
overestimate_noun	aXiprAkkalana/awyanumAna/aXika_AkanA/aXika_kUwanA
overhauling_noun	pUrI_jAca/pUrI_marammawa/ovarahoYla
overlapping_noun	awivyApwi/parasparavyApwi
overleaf_noun	xUsare_pqRTa_para/xUsarI_ora/(pqRTa_kI)
overpayment_noun	aXika_BugawAna
overriding_noun	aXiBAvI/aXyArohI
overseer_noun	ovarasiyara
oversight_noun	cUka
overtime_noun	awirikwa_samaya/samayopari
overvaluation_noun	aXimUlyana
p.p.call_noun	vyakwi_viSeRa_kAla/pIpI_kAla
package_noun	pEkeja/ikamuSwa
packer_noun	pEkara
packet_noun	puliMxA/pEketa
packing_noun	pEka_karanA/bAXanA
pact_noun	samaJOwA
pad_noun	gaxxI/pEda
paediatrician_noun	bAla-cikiwsaka
pager_noun	pejara/pqRTaka
pagination_noun	pqRTa_safKyA_dAlanA/pqRTa_afkana
paid_noun	praxawwa/xawwa_savewana/BugawAna_kiyA_huA/uwwIrNa
painter_noun	rafgasAja/ciwrakAra
palaeographer_noun	purAlipiSAswrI
pamphlet_noun	pEMPaleta
panel_noun	nAmikA
panic_noun	KalabalI
paper_noun	kAgaja_pawra/kAgaja-pawra/leKa
para_noun	pErA
paradigm_noun	rUpAvalI
paradox_noun	viroXABAsa
paragraph_noun	pErA
paragraphing_noun	pErA_banAnA
parallel_noun	samAnwara
paralyse_noun	Tappa_karanA/Tappa_honA
paramedical_noun	parAcikiwsA
paramount_noun	parama/savocca/savopari
parasite_noun	parajIvI
parasitologist_noun	parajIvIvijFAnI
parcel_noun	pArsala
pardon_noun	kRamA/kRamA_karanA
parent_noun	mAwA/piwA_mUla
parentage_noun	mAwA-piwA_kA_nAma/mAwA-piwA
parental_noun	pEwqka
parents_noun	mAwA-piwA
parity_noun	samAnawA
parliament_noun	saMsax
parliamentary_noun	saMsaxIya
parole_noun	pErola
part-time_noun	aMSakAlika
part_noun	BAga/aMSa_(BUmikA_(pujI
partial_noun	AMSika_pakRapAwapUrNa
partiality_noun	pakRapAwa
participant_noun	sahaBAgI/BAga_lene_vAlA
participate_noun	BAga_lenA/safmmaliwa_honA
particular_noun	viSeRa/KAAsa
particulars_noun	byorA/vivaraNa
partition_noun	viBAjana/batavArA
partner_noun	BAgIxAra
partnership_noun	BAgIxArI
party_noun	pakRa/pakRakAra/pArtI/xala_pArtIZ_(prIwi_Boja)/xAvawa
pass_noun	pAsa/pAraNa/pAsa_karanA/pAra_jAnA/gujaranA/uwwIrNa
passage_noun	mArga/galI/galiyArA/aMSa/uxXaraNa/yAwrA/yAwrA_vyaya
passbook_noun	pAsabuka
passive_noun	nifRkraya
passport_noun	pAra-pawra/pAsaporta
patent_noun	peteMta/ekasva
pathologist_noun	vikqwivijFAnI
patriot_noun	xeSaBakwa
patrolman_noun	pEtrolamEna
patron_noun	saMrakRaNa/grAhaka
patronage_noun	saMrakRaNa
pattern_noun	pEtarna/prawirUpa
paucity_noun	kamI/aBAva
pauper_noun	akiMcana
pawn_noun	Xarohara/giravI_raKanA
pay_noun	vewana
payable_noun	xeya/BugawAnI
payee_noun	pAne_vAlA/AxAwA
payer_noun	BugawAnakarwA_(xAwA
payment_noun	BugawAna/sanxAya/axAyagI
pecuniary_noun	Xana_sambanXI
penal_noun	xANdika/SAswika_(viXi)
penalize_noun	xaNdiwa_karanA
penalty_noun	xaNda_arWaxaNda/jurmAnA_SAswi
pending_noun	anirNIwa/padA_huA/rUkA_huA/lambiwa_waka/paryawa
penologist_noun	xaNdaSAswrI
pension_noun	peMSana
pensionable_noun	peMSanayogya/peMSanI
pensioner_noun	peMSanara
peon_noun	caparAsI
percent_noun	prawiSawa/PIsaxI
percentage_noun	prawiSawawA/prawiSawa_xara
perennial_noun	bArahamAsI/cirasWAyI
perforation_noun	CixraNa
perforce_noun	jabaraxaswI/balAw
perform_noun	pAlana_karanA/karanA/niRpAxana
performance_noun	niRpAxana/pAlana
period_noun	avaXi/kAlAvaXi
periodical_noun	pawra/sAmayikI/pawrikA/AvaXika/samaya-samaya_para/sAmayika/niyawa_kAlika
perishable_noun	vinASavAna/vinASaSIla/vikArI
perjury_noun	SapaWaBafga/SapaWa_para_miWyA_sAkya/JUTI_gavAhI
permanency_noun	sWAyiwva
permanent_noun	sWAyI
permissible_noun	anumeya/anujFeya
permission_noun	anujFA/anumawi
permit_noun	anujFA-pawra/paramita/anujFA_xenA/anumawi_xenA
permitted_noun	anujFapwa/anumiwaprApwa/anumawi_xI_jAwI_hE
perpetual_noun	SASvawa/niranwara_cira
perpetuity_noun	SASvawawA/SASvawakAla
perquisites_noun	AnuRafgika_labXiyA/anulabXiyA
personal_noun	vEyakwika
personality_noun	vyakwiwva
personate_noun	prawirUpaNa_karanA
personation_noun	prawirUpaNa
personnel_noun	kArmika
perspective_noun	sanxarSa/pariprekya
persuade_noun	samaJAnA/manAnA/sahamawa_karAnA
persual_noun	avalokana/xeKanA
persuasion_noun	samaJAnA-buJAnA/manAnA/anunaya
pertinent_noun	safgawa
pesticide_noun	pestanASI
petition_noun	yAcikA/arjI
petitioner_noun	yAcikAxAwA/prArWIZ
pharmaceutist_noun	BeRaja_nirmANa_vijFAnI
pharmacist_noun	BeRajajFa
pharmacognosist_noun	BeRaja_afBajFAnI
pharmacologist_noun	BeRajaguNa_vijFAnI
phased_noun	prAvasWAbaxXa/caraNabaxXa
phenomenon_noun	GatanA
photographed_noun	Poto-ciwriwa
photographer_noun	PotogrAPara
photostat_noun	Potosteta
physician_noun	cikiwsaka/PLjISiyana
physicist_noun	BOwikavix
physio-therapist_noun	BOwika-cikiwsaka
physiologist_noun	SarIra-kriyA_vijFAnI
physique_noun	SArIrika_gaTana
pickler_noun	pariRkAraka
pilot_noun	mArgaxarSaka/vimAna_cAlaka/pAilata
pioneer_noun	agraNI
piracy_noun	cOrya
pisciculture_noun	mawsyapAlana
pisciculturist_noun	mawsyapAlanavix/maCalIpAlanavix
placement_noun	nOkarI_xilAnA/sWAnana
plaint_noun	vAxa-pawra
plaintiff_noun	vAxI
plan_noun	yojanA
planner_noun	yojanAkAra
planning_noun	yojanA/AyojanA/yojanA_banAnA
plant_noun	saMyanwraca_pAxapa/pOXA
plantation_noun	ropaNa/vqkRAropaNa/bAgAna
plater_noun	pletara
player_noun	vAxaka_KilAdI
plea_noun	warka/xalIla_afBavacana/afBavAk(viXi)
plead_noun	afBavacana_karanA/pEravI_karanA
pleader_noun	afBavakwA/plIdara
pleasure_noun	prasAxa
plebiscite_noun	janamawa-safgraha
pledge_noun	giravI_raKanA/prawijFA_karanA
pledgee_noun	giravIxAra
pledger_noun	giravIkarwA
plenary_noun	pUrNa
plenipotentiary_noun	pUrNAXikArI
plumber_noun	nalasAja
plunder_noun	lUtapAta_karanA
pointsman_noun	pEtamEna/kAtevAlA
police_noun	ArakRI/pulisa
policy_noun	poYlisI_nIwi_(bImA)
polisher_noun	pAliSagara
poll_noun	mawaxAna
polling_noun	mawaxAna
pollution_noun	praxURaNa
polyandry_noun	bahupawiwva
polygamy_noun	bahuvivAha_(praWA)
pool_noun	pUla
pooling_noun	pUlana
poor_noun	GatiyA
porhibited_noun	nifRaxXa
portable_noun	suvAhya
porter_noun	portara/BArika
positive_noun	niSciwa/niScayAwmaka_sakArAwmaka
possess_noun	kabjA_karanA
possession_noun	kabjA
post-audit_noun	uwwara_leKAparIkRA
post-dated_noun	uwwara-xinAfkiwa
post_noun	paxa/dAka/keMxra/cOkI
postage_noun	dAka-vyaya
posthumous_noun	maraNoparAnwa/maraNowwara
posting_noun	wEnAwI/iMxarAja
postman_noun	dAkiyA/postamEna
postpone_noun	mulwavI_karanA/sWagiwa_karanA
postponement_noun	mulwavI/sWagana
potential_noun	viBava/samBAvya/kAryakRama
power_noun	Sakwi/bijalI/aXikAra
powerloom_noun	pAvaralUma/maSInakaraGA
practice_noun	pqxXawi_karma/peSA
pre-audit_noun	pUrva-leKAparIkRA
pre-emption_noun	agrakraya/SuPA
pre-planned_noun	pUrvaniyojiwa
pre-revised_noun	saMSoXana_pUrva
preamble_noun	uxxeSikA
precaution_noun	pUrvAvaXAna/pUvopAya/ehawiyAwa
precedence_noun	pUrvawA/agrawA
precedent_noun	pUrva_uxAharaNa/najIra
preceding_noun	pUrvavarwIZ
precincts_noun	prasImA
precis_noun	sAraleKa
precise_noun	TIka-TIka/sUkma:/yaWArWa/yaWAvaw_/pramiwa_(viXi)
preclude_noun	roka_xenA/prawivAriwa_karanA
preconception_noun	pUrvaXAraNA/pUrvasafkalpanA
predeceased_noun	pUrvaBUwa
predecessor_noun	pUrvaja/pUrvAXikArI/pUrvavarwIZ
predominant_noun	praXAna/prabala/praBAvI
preface_noun	praswAvanA
prefect_noun	fpraPekta
prefer_noun	warajIha_xenA/aXimAna_xenA
preferable_noun	varIya/aXimAnya
preference_noun	aXimAna/wahajIha
prefix_noun	pUrvayojana/AramBa_meM_jodanA
prehistoric_noun	prAgEwihAsika
prejudice_noun	prawikUla_praBAva/pUrvAgraha/prawikUla_praBAva_dAlanA/pUrvAgraha_uwpanna_karanA
prejudicial_noun	prawikUla/hAnikara
preliminary_noun	prAswAvika/prAraMfBaka
premature_noun	samayapUrva_akAla
premise_noun	AXArikA
premises_noun	parisara/ahAwA
premium_noun	bImA-kiswa/prImiyama/baDOwI
preoccupation_noun	pUrvavyaswawA/vyaswawA
prepaid_noun	pUrvaxawwa
preparation_noun	wEyArI
prepone_noun	pUrviwa_karanA
preponement_noun	pUrvana
prerogative_noun	paramAXikAra
prescribe_noun	vihiwa_karanA/nirXAriwa_karanA/ORaXa-nirxeSana
prescribed_noun	vihiwa/nirXAriwa
presence_noun	upafsWfAwa/mOjUxagI/hAjLrI
presentation_noun	praswuwIkaraNa
presenter_noun	praswowA
presents_noun	vileKa_BeMta/upahAra
preservation_noun	parirakRaNa
preserve_noun	banAe_raKanA/parirakRiwa_raKanA
preside_noun	aXyakRawA_karanA/saBApawiwva_karanA
president_noun	rARtrapawi_aXyakRa/rARtrapawi/aXyakRa/saBApawi
press_noun	muxraNAlaya/presa_samAcArapawra/aKabAra_presa
pressman_noun	prEsamEna/muxraNa_karmacArI/pawrakAra/presamEna
presumed_noun	prakalpiwa
presupposed_noun	pUrvakalpiwa
pretest_noun	pUrvaparIkRaNa
pretext_noun	bahAnA
prevail_noun	pracaliwa_honA/afBaBAvI_honA
prevailing_noun	vixyamAna/varwamAna
prevent_noun	rokanA/nivAraNa_karanA
prevention_noun	nivAraNa/rokaWAma/niroXa
preventive_noun	nivAraka
pricing_noun	kImawa_nirXAraNa
primarily_noun	muKyawa:/praWamawa:/prAWamika_wOra_para
primary_noun	prAWamika
principal_noun	prAcArya/fpraMsipala/praXAna/mUlaXana_mAlika/svAmI/praXAnAcArya
printer_noun	muxraka
printing_noun	muxraNa
priority_noun	prAWamikawA/agrawA
prison_noun	kArAgAra/jela
prisoner_noun	kExI/banxI
privacy_noun	ekAnwa
private_noun	prAiveta/nijI/gEra-sarakArI
privilege_noun	viSeRAXikAra
prize_noun	inAma/puraskAra
prljectionist_noun	prakRepaka
pro-rata_noun	yaWAnupAwa
pro-vice-chancellor_noun	sama-kulapawi
probability_noun	samBAvyawA
probate_noun	probeta
probation_noun	parivIkRA/paraKa/AjamAiSa
probationary_noun	parivIkRAXIna
probationer_noun	parivIkRAXIna/paraKAXIna/AjamAiSI
probe_noun	CAnabIna
procedure_noun	kAryaviXi/prakriyA/kriyAviXi
proceedings_noun	kAryavAhI
proceeds_noun	Agama/prApwi
process_noun	prakrama/prakriyA/saMsAXiwa_karanA/AxeSikA_(viXi)
processing_noun	prakramaNa_saMsAXana
procession_noun	julUsa/SoBAyAwrA
proclaim_noun	uxGoRaNA_karanA
proclamation_noun	uxGoRaNA
procurement_noun	vasUlI/prApaNa
produce_noun	upaja/uwpAxana_praswuwa_karanA/peSa_karanA
product_noun	uwpAxa/upaja/guNanaPala
production_noun	uwpAxana/pExAvAra/praswuwIkaraNa
profession_noun	saMvyavasAya/vqfwwa
professional_noun	saMvyAvasAyika/vqfwwaka
professor_noun	AcArya/proPesara
proficiency_noun	pravINawA
profit_noun	lABa
proforma_noun	prapawra/PoYrma_nixarSana-pawra
programme_noun	kAryakrama_kramAxeSa
programmer_noun	kramAxeSaka/kampyUtara)/progrAmara
progress_noun	pragawi
progressive_noun	pragawiSIla_pragAmI
progressman_noun	pragawi_vIkRaka
prohibit_noun	manA_karanA/niReXa_karanA/prawiReXa_karanA
prohibition_noun	niReXa_naSAbanxI/maxyaniReXa
project_noun	pariyojanA
projection_noun	prakRepa/prakRepaNa
projectionist-cum-mechanic_noun	prakRepaka
prominent_noun	pramuKa
promise_noun	vacana
promote_noun	paxonnawi_karanA/pronnawi_karanA/unnawi_karanA/baDAvA_xenA/pravarwana_karanA
promotee_noun	paxonnawa
promoter_noun	pravarwaka/sampravarwaka_(viXi)
promotion_noun	pronnawi/paxonnawi/warakkI/saMvarXana
promt_noun	wuranwa/SIGra/wawkAla
promulgation_noun	praKyApana
pronounce_noun	sunAnA/sunAyA_jAnA
pronouncement_noun	ElAna_nirNaya_sunAnA
proof_noun	pramANa_prUPa_(presa)
propagate_noun	pracAra_karanA
propagation_noun	pracAra
proper_noun	uciwa/samuciwa
property_noun	sampafwwa/jAyaxAxa/guNaXarma/sAja_sAmAna
proportion_noun	samAnupAwa
proportionate_noun	samAnupAwI/samAnupAwika
proposal_noun	praswAva/prasWApanA
propose_noun	praswAva_karanA/praswAviwa_karanA/prasWApanA_karanA_(viXi)
proposer_noun	praswAvaka/prasWApaka
proposition_noun	praswAva/prasWApanA
propound_noun	prawipAxiwa_karanA
proprietary_noun	sAmpafwwaka/mAlikAnA/ekAyawwa/(ORaXiyA)
propriety_noun	Ociwya
prorogue_noun	sawrAvasAna_karanA
proscribe_noun	afBanifRaxXa_karanA
prosecuter_noun	afBayojana_nirIkRaka
prospectively_noun	uwwawaravyApI_praBAva_se/BaviRyalakRI_praBAva_se
prospectus_noun	vivaraNa-pawrikA
prosper_noun	unnawi_karanA/samqxXa_honA
prosperous_noun	samaxXa/sampanna
protection_noun	saMrakRaNa/rakRaNa
protest_noun	viroXa/prawivAxa
protocol_noun	nayAcAra/protokoYla
prove_noun	sixXa_karanA/pramANiwa_karanA/sAbiwa_karanA
provide_noun	upabanXiwa_karanA/prAvaXAna_karanA
provided_noun	baSarwe/paranwu
provision_noun	upabanXa/Sarwa/vyavasWA/prAvaXAna
provisional_noun	ananwima
provisions_noun	rasaxa
proviso_noun	paranwuka/Sarwa
provocation_noun	prakopana
provost_noun	provosta/provo
proximate_noun	nikatasWa/samIpasWa
proximity_noun	nikatawA/sAmIpya
proximo_noun	AgAmI_mAsa_kA
proxy_noun	prawipawra/prawipawrI/parokRI
psychiatrist_noun	manaScikiwsaka
psychologist_noun	manovijFAnI
public_noun	janawA/pablika/sArvajanika/Ama/loka-sarakArI
publication_noun	prakASana
publicity_noun	pracAra
publicly_noun	Kule_rUpa_se/sArvajanika_rUpa_se
publish_noun	prakASiwa_karanA
pumpman_noun	pampavAlA
punctual_noun	samayaniRTa
punctuality_noun	samaya-pAlana/samaya-pAbanxI
punish_noun	xaNda_xenA/sajA_xenA
punishable_noun	xaNdanIya
punitive_noun	xaNdAwmaka
purchase_noun	kraya/KarIxa/KarIxanA/kraya_karanA
purport_noun	afBaprAya:_wAwpayiwa_honA_(viXi)
purser_noun	powanIsa/parsara
pursue_noun	pICe_lage_rahanA
pursuit_noun	kAma-kAja
purview_noun	kRewra/kAryakRewra
quadruplicate_noun	cOharA/cAra_prawiyA/cOWI_prawi
qualification_noun	ahawA/yogyawA
qualify_noun	ahawA_prApwa_karanA
qualitative_noun	guNAwmaka
quality_noun	guNa/viSeRawA/guNawA/guNavawwawA/koti/prakAra
quantity_noun	mAwrA/parimANa/rASi
quantum_noun	pramAwrA/mAwrA
quarantine_noun	safgaroXa/kvAraNtAina
quarrymen_noun	KaxAnakAra
quarterly_noun	wrEmAsika/wimAhI
quash_noun	afBaKaNdiwa_karanA/maMsUKa_karanA
quasi-permanency_noun	sWAyivawwA
quasi-permanent_noun	sWAyivaw
quasi_noun	vawa/-_kalpa
query_noun	praSna/praSnacihna
quest_noun	walASa/Koja
question_noun	praSna
questionable_noun	SafkAspaxa
questionnaire_noun	praSnamAlA
quinquennial_noun	paFcavAfrRakI
quorum_noun	korama/gaNapUrwi
quota_noun	kotA
quotation_noun	BAva/xara/xara_sUcI/uxXaraNa_koteSana
quote_noun	uxXqwa_karanA/xara_bawAnA
race_noun	prajAwi/xOda/hoda
radiographer_noun	eksa-re_ciwraka
radiologist_noun	vikiraNavijFAnI
radius_noun	arXavyAsa_GerA
raid_noun	CApA/CApA_mAranA/XAvA/XAvA_bolanA
random_noun	yAxqcCika/sAMyogika/aniyamiwa
range_noun	parAsa/cAxamArI/reMja
ranger_noun	rAjika/reMjara
rank_noun	paxa/ohaxA/SreNI/pafkwi
rare_noun	xulaBa/virala
rash_noun	uwAvalA_anXAXunXa
rate_noun	xara/reta
rates_noun	pOra-kara
ratification_noun	anusamarWana
ratio_noun	anupAwa
ration_noun	rASana/rasaxa/Bojya-sAmagrI
rational_noun	yukwisafgawa
rationalization_noun	yukwIkaraNa/Ociwya-sWApana
rationing_noun	rASana_(vyavasWA)
re-employment_noun	punaniyojana
re-entry_noun	puna:_praveSa/puna:_jAca
re-examination_noun	puna:_parIkRA/puna:_jAca_karanA
re-examine_noun	puna:_parIkRA_lenA
reaction_noun	prawikriyA
reactivation_noun	puna:_sakriyaNa
reading_noun	paTana_vAcana
readjust_noun	puna:samAyojiwa_karanA
real_noun	vAswavika/asalI/yaWArWa
reality_noun	vAswavikawA/asaliyawa/yaWArWawA
realization_noun	vasUlI/ugAhI
realize_noun	anuBava_karanA/mahasUsa_karanA/vasUla_karanA/ugAhanA
reappointment_noun	punaniyukwi
reappropriation_noun	punarviniyojana
reason_noun	warka/kAraNa
reasonable_noun	uciwa/yukwiyukwa
reasoning_noun	warka
reassessment_noun	punanirXAraNa
rebate_noun	GatOwI/CUta
rebut_noun	KaNdana_karanA
recall_noun	prawyAhvAna/vApasa_bulAnA
recapitulation_noun	sAra-kaWana
recede_noun	pICe_hatanA/kama_honA
receipt_noun	Aya_AvawI/prApwi_rasIxa
receive_noun	prApwa_karanA/lenA/agavAnI_karanA/svAgawa_karanA
receiver_noun	pAne_vAlA/prApwikarwA/AxAwA/risIvara
recent_noun	hAlahI_kA/nayA_afBanava
reception-room_noun	svAgawa_kakRa
reception_noun	svAgawa/svAgawa-sawkAra/svAgawa_samAroha
receptionist_noun	svAgawakarwA
receptive_noun	grahaNaSIla/grAhI
recess_noun	avakASa/viSrAnwi
recession_noun	suswI
recipient_noun	pAnevAlA/AxAwA
reciprocal_noun	anyonya/pArasparika/paraspara
reciprocate_noun	AxAna-praxAna_karanA
reciprocity_noun	anyonyawA/pAraspariwA
recitation_noun	pATa/sasvarapATa
reckless_noun	lAparavAha/uwAvalA/anXAXunXa/xussAhasI
recklessness_noun	xussAhasa
reckon_noun	ginanA/gaNanA_karanA
reclaim_noun	BUmi-punarUXAra
reclamation_noun	uXAra/uXAraNa/BUmi-uXAra
recognised_noun	mAnya/mAnyawA_prApwa/afBajFAwa
recognition_noun	mAnyawA/pahacAna/afBajFAna
recognizable_noun	mAnyawA_xene_yogya/pahacAnane_yogya
recognizance_noun	mucalakA
recollect_noun	smaraNa_karanA
recommend_noun	siPAriSa_karanA/saMswuwi_karanA
recommendation_noun	siPAriSa/saMswuwi
recommended_noun	saMswuwa/siPAriSa_kI_jAwI_hE
reconcile_noun	samAXAna_karanA/samAXAna_karAnA/mela-milApa_karanA/mela-milApa_karAnA
reconciliation_noun	samAXAna/mela-milApa
reconsideration_noun	punarvicAra
reconstitution_noun	punargaTana
record_noun	afBaleKa/rikArda/kIrwimAna/afBaliKiwa/xarja_karanA
recorder_noun	afBaleKa/rikArdara
recording_noun	afBaleKabaxXa_karanA/rikArda_karanA
recoup_noun	prawipUrwi_karanA
recoupment_noun	prawipUrwi
recourse_noun	upASraya/upacAra/vasUlI-aXikAra
recover_noun	vasUla_karanA/barAmaxa_karanA/svasWa_honA
recoverable_noun	vasUlI_yogya
recovery_noun	vasUlI/svAsWya-lABa
recreation_noun	manovinoxa
recruit_noun	rafgarUta/BarwI_karanA
recruitment_noun	BarwIZ
rectification_noun	pariSoXana/suXAranA
rectify_noun	pariSoXana_karanA
recurring_noun	AvarwIZ/Avarwaka
redeemm_noun	CudAnA/mocana
redemption_noun	mocana/CudAnA
redirect_noun	puna:_prefRawa_karanA
redistribution_noun	punarviwaraNa
redress_noun	nivAraNa/nivAraNa_karanA/xUra_karanA
reduce_noun	GatAnA/kama_karanA
reduction_noun	kamI/GatOwI
redundant_noun	anAvaSyaka
refer_noun	havAlA_xenA/ulleKa_karanA/nirxeSa_karanA_(vicArArWa)
referee_noun	nirxeSI/reParI
reference_noun	sanxaBa/havAlA/nirxeSa
referencing_noun	sanxaBa_xenA/havAlA_xenA
referendum_noun	janamawa-safgraha
refine_noun	pariRkAra_karanA
reflect_noun	prawibiMbawa_honA/prawibiMbiwa_karanA
reform_noun	suXAra:_suXAranA/suXAra_karanA
refrain_noun	virawa_rahanA_(viXi)/na_karanA
refreshment_noun	jalapAna/upAhAra
refuge_noun	SaraNa/ASraya
refugee_noun	SaraNArWIZ
refund_noun	vApasI(Xana)/prawixAya_(viXi)/Xana_lOtAnA/Xana_PeranA
refundable_noun	lOtAyA_jAne_yogya_prawixeya
refusal_noun	inakAra
refuse_noun	inakAra_karanA/asvIkAra_karanA
refutation_noun	KaNdana
refute_noun	KaNdana_karanA
regain_noun	puna:_prApwa_karanA
regard_noun	XyAna_xenA/vicAra_karanA
region_noun	praxeSa
register_noun	rajistara/paFjI/paFjikA/rajistara_karanA/paFjIkqwa_karanA
registered_noun	paFjIkqwa/paFjIbaxXa/rajistrI_huA
registrar_noun	kula_saciva_(viSvavixyAlaya)/rajistrAra/paFjIyaka
registration_noun	paFjIkaraNa/rajistrIkaraNa
registry_noun	rajistrI
regret_noun	Kexa/Kexa_prakata_karanA
regrettable_noun	Kexajanaka
regrouping_noun	punarvargIkaraNa
regular_noun	niyamiwa
regularization_noun	niyamiwIkaraNa
regulations_noun	vinimaya
rehabilitation_noun	punarvAsa
rehearsal_noun	pUrvAByAsa
reimburse_noun	prawipUrwi_karanA
reimbursement_noun	prawipUrwi
reinstate_noun	puna:_sWApiwa_karanA/bahAla_karanA
reinstatement_noun	bahAlI
reiterate_noun	xoharAnA/Pira_kahanA
reject_noun	asvIkAra_karanA
rejection_noun	asvIkAra/asvIkqwi/nAmaFjUrI/agrahaNa_(viXi)
rejoinder_noun	prawyuwwara
relative_noun	sambanXI/nAwexAra/sApekRa/sApekRika
relax_noun	SiWila_karanA/DIla_xenA/CUta_xenA/viSrAma_karanA
relaxation_noun	CUta/riyAyawa/DIla/viSrAnwi/SiWilIkaraNa
release_noun	mukwi/rihAI/CutakArA/nirmukwi/vimocana_(Xana)/xe_xenA/jArI_karanA
relevant_noun	safgawa/susafgawa
reliable_noun	viSvasanIya/Barosemanxa
reliance_noun	BarosA/viSvAsa/ASraya
relic_noun	purAvaSeRa
relief_noun	sahAyawA/rAhawa/baxala/anuwoRa_(viXi)
relieve_noun	BAramukwa_karanA/nOkarI_se_CuttI_xenA/CuttI_xenA
reliever_noun	evajI
relinquishment_noun	wyAga/CodanA
reluctance_noun	anicCA
remains_noun	avaSeRa
remand_noun	prawipreRaNa/rimANda
remark_noun	ukwi/aByukwi/kahanA/tippaNI_karanA
remedial_noun	upacArI
remedy_noun	upAya/upacAra
reminder_noun	smaraNa-pawra/anusmAraka
remission_noun	parihAra/mAPI/CUta
remit_noun	preRaNa_karanA/BejanA_mAPa_karanA/CodanA
remitee_noun	prefRawI/pAne_vAlA
remittance_noun	preRaNa/BejanA/prefRawa_Xana/BejI_gaI_rakama
remitter_noun	preRaka/Bejane_vAlA
remote_noun	xUravarwIZ/suxUra/parokRa
removal_noun	niRkAsana/hatAyA_jAnA/apanayana
remuneration_noun	pAriSramika/mehanawAnA
render_noun	xenA/samarpiwa_karanA/rUpAnwara_karanA/anuvAxa_karanA
renewal_noun	navIkaraNa
renounce_noun	wyAga_karanA/wyAganA
rent_noun	BAtaka/kirAyA/BAdA_lagAna
reorganization_noun	puna:_safgaTana/punargaTana
reorientation_noun	punarafBavinyAsa
repatriate_noun	xeSa-prawyAvarwana/xeSa_ko_lOtAnA/xeSa_vApasa_BejanA
repatriation_noun	xeSa-prawyAvarwana/prawyAvAsana
repay_noun	SoXana_karanA/cukAnA_lOtAnA/vApasa_karanA
repayable_noun	SoXya_prawixeya
repeal_noun	nirasana/niraswa_karanA
replace_noun	prawisWApiwa_karanA
replacement_noun	prawisWApana/evajI
replenish_noun	puna:pUrwi_karanA
replenishment_noun	puna:pUrwi
report_noun	prawivexana/riporta:/riporta_xenA
reporter_noun	prawivexaka/riportara
repository_noun	niXAna:_safgraha
represent_noun	prawiniXiwva_karanA/afBavexana_xenA
representation_noun	prawiniXiwva/aByAvexana/afBavexeKA_hAla
representative_noun	prawiniXi
reprimand_noun	BawrsanA/PatakAra/XigxaNda_(viXi)
reprisal_noun	prawiSoXa
reproduce_noun	prawikqwi_wEyAra/karanA/pExA_karanA/prajanana_karanA
reproduction_noun	punaruwpAxana/prawilipi/prawikqwi_prajanana
repudiate_noun	nirAkaraNa_karanA
repugnant_noun	prawikUla/virUxXa
repurchase_noun	puna:kraya/Pira_se_KarIxa
reputation_noun	prasifxXa/KyAwi
requirement_noun	apekRA/AvaSyakawA
requisite_noun	AvaSyaka/apekRiwa
requisites_noun	apekRiwa_vaswue/AvaSyaka_vaswue/apekRiwa_guNa/AvaSyaka_guNa
requisition_noun	mAga_aXigrahaNa
resaldar_noun	risAlaxAra
rescind_noun	viKaNdana_karanA
rescue_noun	uxXAra/bacAva:/CudAnA/uxXAra_karanA
research_noun	anusanXAna/gaveRaNA
reservation_noun	ArakRaNa
reserve_noun	rijarva/ArakRiwi:/ArakRiwa_karanA
resettlement_noun	puna:sWApana/punarvAsa
reshuffle_noun	Perabaxala
residence_noun	nivAsa/AvAsa
resident_noun	nivAsI
residential_noun	AvAsa-/nivAsa
residual_noun	avaSiRta
residuary_noun	avaSiRta
residue_noun	avaSeRa
resign_noun	wyAga_pawra_xenA/iswIPA_xenA
resignation_noun	wyAgapawra/iswIPA
resist_noun	prawiroXa_karanA
resolution_noun	safkalpa
resort_noun	ASraya/ASraya_lenA
resource_noun	sAXana/saMsAXana
resourceful_noun	sAXana-sampanna/yukwisampanna
resources_noun	sAXana/saMsAXana/sampaxA
respectfully_noun	sAxara
respectively_noun	kramAnusAra/kramaSa:
respondent_noun	prawyarWIZ/prawivAxI
response_noun	prawyuwwara/uwwara/anukriyA
responsibility_noun	jimmexArI/uwwaraxAyiwva
responsive_noun	anukriyASIla
restitution_noun	prawyAnayana/prawyavasWAna/prawyAsWApana_(viXi)
restoration_noun	puna:sWApana/jINoxXAra
restore_noun	puna:sWApana_karanA/Pira_se_cAlU_karanA/jINoxXAra_karanA
restraint_noun	avaroXa/niyanwraNa/nigraha/saMyama
restricted_noun	prawibanXiwa/sImiwa
restriction_noun	prawibanXa/roka
resume_noun	sAra-vqwwa/puna:_AramBa_karanA/puna:_SurU_karanA
resummon_noun	puna:_sammana_karanA
resumption_noun	punarAramBa
retain_noun	prawiXAriwa_karanA/raKe_rahanA/roka_raKanA
retaliation_noun	prawikAra/baxalA
retire_noun	sevA-nivqwwa_honA/ritAyara_honA/nivqwwa_honA
retired_noun	sevA-nivqwwa/nivqwwa
retirement_noun	sevA-nivqfwwa/nivqfwwa
retoucher-cum-finisher_noun	anuSoXaka_pariRkarwA
retoucher_noun	anuSoXaka
retrenchment_noun	CatanI
retrial_noun	puna:_vicAraNa
retrospective_noun	pUrvavyApI/BUwalakRI
return_noun	vivaraNI/prawilABa/prawiPala/vApasI/vApasa_karanA/lOtAnA/uwwara/nirvAciwa_karanA/nirvAciwa_honA
revalidation_noun	punarvaZEXIkaraNa
revaluation_noun	punarmUlyana/punarmUlyAfkana
revenue_noun	rAjasva
reverse_noun	uwkrama/prawiloma/ultA
reversion_noun	prawyAvarwana
reverted_noun	prawyAvarwiwa
review_noun	samIkRA/punarvilokana/samIkRA_karanA/punarvilokana_karanA
reviewer_noun	samIkRAkAra/samIkRaka/punarvilokaka
revise_noun	punarIkRiwa_karanA/pariSoXiwa_karanA/xoharAnA
reviser_noun	punarIkRaka
revision_noun	punarIkRaNa/pariSoXana/xoharAnA
revival_noun	punarujjIvana/puna:_pravarwana
revocable_noun	prawisaMharaNIya
revocation_noun	prawisaMharaNa
revoke_noun	prawisaMharaNa_karanA
revolution_noun	parikramaNa/krAnwi
reward_noun	pAriwofRaka/puraskAra/prawiPala
rigger_noun	sajjaka/rigara
right_noun	aXikAra
rigman_noun	rigamEna
riot_noun	balavA/xafgA
risk_noun	joKima
rival_noun	prawixvanxvI/viroXI
rivetor_noun	rivetakAra
roadman_noun	sadaka_karmIZ
roadways_noun	sadaka_mArga/rodaveja
role_noun	BUmikA
roll_noun	paFjI/nAmAvalI/Parxa/lapetanA
room_noun	kakRa/kamarA
roster_noun	rostara
rotation_noun	GUrNana/cakrAnukrama
rough_noun	kaccA/rUKA/rukRa/motA
route_noun	mArga
routine_noun	nemI/xaswUrI
royalty_noun	roYyaltI
rude_noun	aSiRta/aBaxra
rule_noun	niyama
ruler_noun	SAsaka/reKaka
ruling_noun	vinirNaya
rumour_noun	aPavAha
runner_noun	harakArA
rural_noun	grAma-/grAmINa/xehAwI
rustication_noun	viniRkAsana
sabotage_noun	woda-Poda/anwaXrvaMsa
sack_noun	nikAla_xenA/barKAswa_karanA
safe_noun	surakRiwa/nirApaxa/Bayarahiwa/aBaya
safeguard_noun	surakRaNa
safeguarding_noun	surakRiwa_raKanA
safety_noun	saMrakRA/surakRA/kRema
sailor_noun	nAvika/nOsEnika
salaried_noun	vEwanika/vewanaBogI
salary_noun	vewana/sambalam
sale_noun	vikraya/bikrI
sales-in-charge_noun	bikrI_praBArI
salesman_noun	bikrIkarwA
salient_noun	pramuKa/muKya
salvage_noun	BraMSa_uxXara/uxXAraNa/kabAda/uxXAraNa-puraskAra
sample_noun	namUnA/prawixaSa/sEMpala
sanction_noun	maFjUrI/saMsvIkqwi
sanctity_noun	paviwrawA
sanctuary_noun	aBayAraNya
sane_noun	svasWaciwwa
sanitary_noun	saPAI_kA/svAsWakara
sanitation_noun	saPAI/svacCawA/svAsWya-rakRA
satisfaction_noun	sanwoRa/sanwufRta/samAXAna
satisfactory_noun	sanwoRapraxa/sanwoRajanaka/samAXAnapraxa
savingram_noun	seviMgrAma/bacawa-wAra
scaffolder_noun	pAda_bAXane_vAlA
scale_noun	mApa/mApakrama/pEmAnA/mApanI/anumApa/mAna
scarcity_noun	nyUnawA/kamI/aBAva
scavenging_noun	saPAI
scenario_noun	parixqSya/sInArio
scenarist_noun	xqSyaleKaka
schedule_noun	anusUcI
scheme_noun	yojanA
scholarship_noun	CAwravqfwwa/vixvawwA
school_noun	skUla/vixyAlaya
scientist_noun	vEjFAnika/vijFAnI
scope_noun	viRaya_kRewra/kArya-kRewra/pariXi/viswAra
score_noun	skora/prApwAfka
scorer_noun	gaNaka
scout_noun	bAlacara/skAuta
screening_noun	CAnabIna
screwer_noun	pecakasiyA
script_noun	AleKa
scrutinizer_noun	saMvIkRaka
scrutiny_noun	saMvIkRA/CAnabIna
sculptor_noun	mUrwikAra
seal_noun	muxrA/mohara/mohara_lagAnA
sealed_noun	moharabanxa
sealer_noun	muxrAfkaka
seaman_noun	nAvika/sImEna
search_noun	walASI/walASa/walASa_karanA
seccession_noun	pArWakya/pqWak_honA
secondary_noun	gONa/mAXyamika
secrecy_noun	gopanIyawA
secret_noun	gupwa/gupwa_bAwa
secretary_noun	saciva/manwrI_(kisI_saMsWA_kA)
section_noun	anuBAga/XArA
sector_noun	sektara/kRewraka
secular_noun	panWanirapekRa/XarmanirapekRa
security_noun	prawiBUwi/surakRA
sedimentationist_noun	avasAxanavix
sedition_noun	rAjaxroha
segregate_noun	pqWaka_karanA/alaga_karanA
seismologist_noun	BUkampavijFAnI
seizure_noun	afBagrahaNa
selection_noun	pravaraNa/selekSana/cayana
self-acquired_noun	svArjiwa
self-defence_noun	AwmarakRA
self-interest_noun	svArWa/nijI_lABa/Awmahiwa
seller_noun	vikrewA
semester_noun	sawrAWa/semestara
semi-autonomous_noun	arXa-svAyawwa
semi-government_noun	arXasarakArI
semi-rural_noun	arXa-grAmINa
semi-skilled_noun	arXa-kuSala
semi-urban_noun	arXa-nagarIya
seminar_noun	vicAra-goRTI/safgoRTI
senate_noun	sIneta/variRTa_saBA
sender_noun	preRaka
senior_noun	variRTa
seniority-cum-fitness_noun	variRTawA_saha_upayukwA
seniority_noun	variRTawA
sensation_noun	saMvexanA/saMvexana
sensitive_noun	saMvexanaSIla
sentence_noun	xaNdAxeSa
sepoy_noun	sipAhI
sequence_noun	anukrama
sergeant_noun	sArajeMta
serialization_noun	kramaNa
sericulturist_noun	reSamavijFAnI
series_noun	mAlA/SreNI/avali
serious_noun	gamBIra
serologist_noun	sIramavijFAnI
servant_noun	sevaka/nOkara
serve_noun	sevA_karanA/wAmIla_karanA/parosanA
service_noun	sevA/nOkarI/vyavasWA/sevAI/wAmIla_(viXi)
serviceable_noun	upayojya/kAma_meM_lAne_yogya
session_noun	sawra/aXiveSana
set-up_noun	vyavasWA/DAcA
set_noun	vinyaswa/samuccaya
setter_noun	setara
settlement_noun	banxobaswa/nipatArA/samaJOwA/vyavasWApana
severally_noun	pqWak-pqWak/alaga-alaga
severance_noun	pqWakkaraNa/vicCexa/viBAjana_(viXi)
sewage_noun	vAhiwa_mala
sex_noun	liMga/kAma
shaper_noun	AkqwikAra
share_noun	aMSa/Seyara/BAga/BAgI_honA/sAJI_honA/BAga_pAnA
shareholder_noun	SeyaraXArI/Seyaraholdara
shift_noun	pArI
shifting_noun	sWAnAnwaraNa
shipping_noun	jahAjarAnI
shipyard_noun	powa_prAfgaNa
short-term-course_noun	alpakAlIna_pATyakrama
shortage_noun	kamI
shortfall_noun	kamI
shorthand_noun	ASulipi
shortlisting_noun	laGusUcIyana
shunter_noun	SaNtara/SaNtakarwA
sign_noun	cihna/safkewa/haswAkRara_karanA
signal_noun	safkewa/siganala
signaller_noun	1-_siganalara/safkewaka_2-_wAra_bAbU
signalman_noun	safkewakAra/siganala_mEna_siganala_vAlA
signature_noun	haswAkRara
significant_noun	mahawvapUrNa/sArWaka
signify_noun	vyakwa_karanA/prakata_karanA/xyowaka_honA
silviculturist_noun	vanavqkRavijFAnI
similar_noun	saxqSa/vEsA_hI/samarUpa
simultaneous_noun	yugapawa/samakRaNika
simultaneously_noun	eka_sAWa/eka_hI_samaya_para
sincere_noun	niRkapata/saBAvI/niRTAvAna
sir_noun	SrIman_/mahoxaya
sister-in-charge_noun	praBArI_bena/praBArI_sistara
site_noun	sWala/sWAna
sketch_noun	reKAciwra
skidman_noun	fskadamEna
skinner_noun	carmakAra
skipper_noun	fskapara
slackness_noun	SiWilawA/fDalAI
slander_noun	apamAnavacana
slip_noun	parcIZ/cUka
slum_noun	ganxI_baswI
smartness_noun	cuswI
smooth_noun	nirviXna
smuggle_noun	waskarI_karanA
smuggler_noun	waskara
smuggling_noun	waskarI
society_noun	samAja/sosAitI
software_noun	prakriyA_sAmagrI_/soYPtaveyara
soil_noun	mqxA/mittI/BUmi
sojourn_noun	avasWAna/virAma
sole_noun	walA_/ekamAwra
solemn_noun	sawyaniRTa/gamBIra
solemnity_noun	gamBIrawA/gAmBIrya
solemnly_noun	sawyaniRTApUrvaka_/sawyaniRTA_se
solicit_noun	yAcanA_karanA/prArWanA_karanA
solicitor_noun	soYlisItara
solitary_noun	ekAnwa/ekamAwra/akelA
solution_noun	sAXana/hala
solve_noun	hala_karanA/samAXAna_karanA
solvency_noun	SoXana-kRamawA
solvent_noun	SoXanakRama
sorter_noun	CatAIkarwA/soYrtara
sorting_noun	CatAI
source_noun	s/Aowa/uxgama
souvenir_noun	smArikA
sovereign_noun	aXirARtra/sampraBu/praBusawwAsampanna/praBuwvasampanna
sovereignty_noun	sampraBuwA/savocca_sawwA
space_noun	anwarikRa/anwara/sWAna/jagaha
spacing_noun	anwarAlana
spare_noun	awirikwa
speaker_noun	aXyakRa/vakwA/1-_vakwA_2-_aXyakRa_(loka_saBA/viXAna_saBA_maNdala)
special_noun	viSeRa
specialist_noun	viSeRajFa
specialization_noun	viSeRajFawA
specific_noun	vinixiRta
specification_noun	vinirxeSa/viSifRta
specimen_noun	namUnA
speculation_noun	sattA/atakala
speech_noun	BARaNa
speed_noun	cAla/raPwAra/gawi
sphere_noun	golA_kRewra
spokesman_noun	pravakwA
sponsor_noun	prAyojaka/prAyojiwa_karanA
sports_noun	Kela-kUxa
spouse_noun	vivAhiwI/pawi_yA_pawnI
squad_noun	skavoYda/xaswA
stability_noun	sWirawA
staff_noun	amaMlA/karmacArI-varga/stAPa
stage_noun	rafgamaFca/avasWA/prakrama
stagnation_noun	gawiroWa/gawihInawA
stalemate_noun	gawyavaroXa
stamp_noun	tikata/stAmpa/mohara/muxrAfka
stamping_noun	mohara_lagAnA
standard_noun	mAnaka/swara
standardization_noun	mAnakIkaraNa
standing_noun	sWAyI
starred_noun	wArAfkiwa
state_noun	rAjya_sWiwi/xaSA/avasWA/hAlawa
statement_noun	kaWana_bayAna/vakwavya_vivaraNa
statesman_noun	rAjamarmajFa
static_noun	sWira
station_noun	steSana/keMnxa
stationary_noun	sWira/acala
stationery_noun	leKana-sAmagrI
statistical_noun	sAMfKyakI
statistics_noun	sAMfKyakI/Akade
status_noun	sWiwi/hEsiyawa/prawiRTA
statute_noun	saMviXi/kAnUna
statutory_noun	sAMviXika/kAnUnI
stay_noun	roka/roka_xenA/roka_lagAnA
steady_noun	sWira/sanwuliwa
stencil_noun	steMsila
stenciling_noun	steMsilana
steno_noun	steno/ASuleKaka
stenographer_noun	ASulipika/stenogrAPara
stenography_noun	ASulipi
stereotyped_noun	rUDa/rUfDabaxXa
sterility_noun	niRPalawA/banXyawA
sterilization_noun	visafkramaNa/banXyakaraNa/nasabanxI
steward_noun	stuarda
stigma_noun	lAFCana/kalafka/XabbA
stimulate_noun	uojiwa_karanA
stimulation_noun	uojanA/uojana
stipend_noun	vqwwawikA/vajIPA
stipendiary_noun	vqfwwakAgrAhI/vEwanika
stipulate_noun	anuparNIZ/anubanXa_karanA
stipulation_noun	anubanXa
stock-taking_noun	mAla_kI_padawAla/stoYka-milAna
stock_noun	sAmAna/mAla/stoYka/SeRa_mAla
stocker_noun	stoYkara
stockist_noun	stoYkista
stockman_noun	paSupAlaka
stop_noun	virAma
stoppage_noun	roka
storage_noun	BaNdAraNa/saFcayana
store_noun	BaNdAra
storeman_noun	BaNdArakarmI
stores_noun	sAmAna/sAmagrI/BaNdAra
storey_noun	mafFjala
straight_noun	sIXA/sarala/KarA/spaRta
strain_noun	wanAva
stranded_noun	PasA_haA/asahAya
strange_noun	apariciwa/viciwra
stranger_noun	apariciwa/ajanabI
strap_noun	PIwA/pattI
strata_noun	swara
strategy_noun	raNanIwi/kAryanIwi
stratification_noun	swaraNa
stream_noun	XArA
streamline_noun	supravAhI_banAnA
strength_noun	sAmaWrya/safKyA
strengthen_noun	majabUwa_karanA/samarWa_banAnA/saSakwa_karanA
strenuous_noun	SramasAXya
stress_noun	jora_xenA/bala_xenA
stretcher_noun	strecara
strict_noun	kadA/kaTora/saKwa
strictly_noun	saKwI_se/kaTorawA_se/vAswava_meM
strictness_noun	saKwI/kaTorawA
stricture_noun	avakRepa_(viXi)
strike_noun	hadawAla/ApAwa_karanA
stringency_noun	kaTorawA/kadApana/wafgI
stringer_noun	Putakara_saMvAxaxAwA
strip_noun	pattI
strive_noun	prayAsa_karanA
structural_noun	saMracanAwmaka
structure_noun	saMracanA
struggle_noun	safGarRa
stubborn_noun	jixxI/haTI
student_noun	vixyArWIZ/CAwra
studio_noun	stUdiyo
studios_noun	aXyayanaSIla/pariSramI
study_noun	aXyayana
stuff_noun	sAmagrI
stupendous_noun	vismayakArI_bqw
style_noun	SElI/Dafga
sub-committee_noun	upa-samiwi
sub-contract_noun	upa-TekA/upa-saMvixA
sub-district_noun	upa_jLlA
sub-division_noun	upapraBAga/sabadivIjana/upaKaNda/upaviBAjana
sub-head_noun	upa-SIrRa
sub-lease_noun	upa_pattA/SikamI_pattA
sub-rule_noun	upa_niyama
sub-section_noun	upa-XArA
subedar_noun	sUbexAra
subject_noun	viRaya/nAgarika
subjective_noun	AwmaniRTa/vyakwiparaka
subjects_noun	prajA
subletting_noun	upa-kirAexArI/upaBAdA
submission_noun	nivexana/aXInawA_svIkAra_karanA/praswuwIkaraNa/peSI/aXInawA
submissive_noun	vinIwa/vinamra
submit_noun	praswuwa_karanA/nivexana_karanA
subordinate_noun	aXInasWa/aXIna/mAwahawa
subscribe_noun	canxA_yA_Sulka_xenA/grAhaka_bananA/samarRana_karanA/sahamawa_honA/haswAkRara_karanA
subscription_noun	afBaxAna_canxA
subsequent_noun	bAxa_kA/uwwaravarwI/anuvarwIZ/uwwaraBAvya_(viXi)
subsequently_noun	bAxa_meM/wawpaScAw
subsidiary_noun	gONa/sahAyaka/samanuRafgI_(viXi)
subsidise_noun	ArWika_sahAyawA_xenA/imaxAxa_xenA
subsidised_noun	imaxAxI/ArWika_sahAyawA-prApwa
subsidy_noun	sahAyikI/imaxAxa
subsistence_noun	nirvAha
subsititute_noun	ekjI/prawisWAnI/prawisWApiwa_karanA
substance_noun	paxArWa/sAra
substandard_noun	avamAnaka
substantial_noun	sAraBUwa/sAravAna/paryApwa
substantiate_noun	sixXa_karanA/puKwA_karanA
substantive_noun	mOlika/mUla
substitution_noun	prawisWApana/ke_sWAna_para_raKanA
suburb_noun	upanagara
suburban_noun	upanagarIya
subvention_noun	rAjakIya_sahAyawA/ArWika_sahAyawA
subversion_noun	XvaMsa
subway_noun	surafgamArga
succeeding_noun	uwwaravarwIZ
succession_noun	uwwarAXikAra/uwwaravarwana
successive_noun	uwwarowwara/Anukramika
successor_noun	uwwarAXikArI
succour_noun	sahAyawA/sahAyawA_praxAna_karanA
sue_noun	mukaxamA_calAnA/vAxa_calAnA
suffer_noun	sahanA/pIdLwa_honA
suffering_noun	kaRta/pIdA
sufficient_noun	paryApwa
suffix_noun	anuyojana/anwa_meM_jodanA
suffrage_noun	mawAXikAra
suggestion_noun	suJAva
suggestive_noun	sAfkewika/vyaFjanAwmaka
suicide_noun	AwmahawyA
suit_noun	xAvA/mukaxamA/vAxa/upayukwa/anukUla
suitability_noun	upayukwawA/anukUlawA/Ociwya
suited_noun	upayukwa
sum_noun	rASi/rakama/yogaPala/joda
summarily_noun	sarasarI_wOra_para/safkRepa_meM
summary_noun	sArAMSa
summit_noun	SiKara
summon_noun	AhavAna_karanA
summons_noun	sammana
sundry_noun	Putakara/viviXa
super-tax_noun	aXikara
superannuation_noun	aXivafrRawA
superficial_noun	UparI/sawahI
superfluous_noun	awirikwa
superimpose_noun	aXyAropaNa_karanA
superintendence_noun	aXIkRaNa
superintendent_noun	aXIkRaka
superior_noun	variRTa/ucca
superiority_noun	variRTawA
supernumerary_noun	aXisafKya
superscribe_noun	Upara_liKanA
superscription_noun	uparileKa/uparileKana/pawA
supersede_noun	aXikramaNa_karanA
supersession_noun	aXikramaNa
superstructure_noun	UparI_DAcA/aXiracanA
supervise_noun	paryavekRaNa_karanA
supervision_noun	paryavekRaNa/xeKareKa
supervisor_noun	paryavekRaka/suparavAijara
supervisory_noun	paryavekRI
supplement_noun	pariSiRta/pUraka/anupUraka_(viXi)/jodanA/anupUraNa
supplementary_noun	anupUraka
supplier_noun	praxAyaka/pUrwikAra
supply_noun	pUrwi/praxAya/praxAna_karanA
support_noun	samarWana/Alamba_lagAnA
supporter_noun	samarWaka
suppress_noun	xamana_karanA/xabAnA
suppression_noun	xamana
supremacy_noun	savoccawA
supreme_noun	savocca
surcharge_noun	aXiBAra
surcharged_noun	aXiBAriwa
surety_noun	prawiBU_/jAmina_jamAnawa
surgeon_noun	Salya-cikiwsaka/sarjana
surgery_noun	Salya-cikiwsA/sarjarI
surname_noun	kulanAma
surplus_noun	aXiSeRa
surrender_noun	aByarpaNa
surrenders_noun	aByarpiwa_rASiyA
surroundings_noun	pariveSa
surtax_noun	awikara
surveillance_noun	nigarAnI
survey_noun	sarvekRaNa
surveyor_noun	sarvekRaka
survival_noun	uwwarajIviwA
surviving_noun	uwwarajIvI/avaSiRta
survivor_noun	uwwarajIvI
susceptibility_noun	pravaNawA/AgrAhiwA
suspect_noun	sanxigXa_vyakwi/sanxeha_karanA
suspend_noun	nilambiwa_karanA/muawwala_karanA
suspended_noun	nilambiwa
suspense_noun	asamaFjasa/ucanwa
suspension_noun	nilambana/muawwalI
suspicion_noun	sanxeha/saMSaya
sustainable_noun	XAraNIya
sustained_noun	lagAwAra
swear_noun	SapaWa_lenA/SapaWa_grahaNa_karanA
swearing-in-ceremony_noun	SapaWa_grahaNa_samAroha
sweeper_noun	saPAIvAlA
switchman_noun	svicamEna
syllabus_noun	pATya_vivaraNa
symbol_noun	prawIka
symmetry_noun	samamiwi/samarUpawA
sympathy_noun	sahAnuBUwi/samavexanA
symposium_noun	parisaMvAxa
symptom_noun	lakRaNa
synchronise_noun	sAWa-sAWa_honA/sAWa-sAWa_GatanA
syndicate_noun	afBaRaxa/siMdiketa
synopsis_noun	rUpareKA/viRaya-safkRepa/sAra-safkRepa
synthesis_noun	saMSleRaNa
synthetic_noun	saMfSlaRta
system_noun	nikAya/wanwra/paxXawi/praNAlI
systematic_noun	vyavasWiwa
table_noun	meja(Z_patala/sAraNI/wAlikA
tableau_noun	JAkI
tabular_noun	sAraNIbaxXa
tabulation_noun	sAraNIyana/sAraNIbaxXa_karanA
tabulator_noun	sAraNIyanwra/sAraNIkAra
tackle_noun	sulaJAnA/nipatanA/nipatAnA
tact_noun	yukwi/cAwurya
tactful_noun	vyavahArakuSala/cAwuryapUrNa/cawura
tactical_noun	yukwika
tactless_noun	avyAvahArika/vyavahAraSUnya
tag_noun	tEga/nawWI_karanA
tailor_noun	xarjIZ/telara
talented_noun	prawiBAsampanna/prawiBASAlI
tally_noun	ginawI/safKyA/milAna_karanA/mela_KAnA
tampering_noun	hera-Pera_karanA/gadabada_karanA/bigAdanA/wodanA_(sAkya_ko)
tangible_noun	mUrwa
tanner_noun	carmaSoXaka
tanning_noun	caramaSoXana/camadA_kamAnA
tape_noun	tepa/PIwA
tapping_noun	upayoga_karanA_(saMsAXanoM_kA)/tEpa_karanA_(Pona_kA)
tardiness_noun	SiWilawA/Alasya
tare_noun	XadA/KAlI_gAdI_kA_BAra/teyara
target_noun	lakya
tariff_noun	tEriPa/xarasUcI
tarnish_noun	malina_karanA/XUmila_karanA
task_noun	kAma/kArya
taster_noun	caKaniyA
tax-free_noun	karamuwa
tax_noun	kara
taxable_noun	karayogya
taxation_noun	karAXAna/kara_lagAnA
teacher_noun	aXyApaka
technical_noun	wakanIkI/praviXika/Silpika_pAriBAfRaka
technician_noun	wakanIkavix/wakanISiyana/wakanIkavixa/praviXijFa
technique_noun	wakanIka
technocracy_noun	praviXiwanwra
technocrat_noun	praviXiwanwrI/teknokrEta
technological_noun	prOxyogikI
technologist_noun	prOxyogikIvix/prOxyogikIvix_/SilpavijFAnI
technology_noun	prOxyogikI
telegram_noun	wAra
telegraphist_noun	wAra_safkewaka
telegraphy_noun	wAra-saFcAra/telIgrAPI
television_noun	xUraxarSana/telIvijana
teller_noun	gaNaka
temper_noun	mijAja/svaBAva
temperament_noun	svaBAva/prakqwi/mijAja
temperamental_noun	wunakamijAja
temperature_noun	wApamAna
tempo_noun	gawi_teMpo
temporal_noun	kAlika/Ehika_(viXi)
temporary_noun	asWAyI
temptation_noun	praloBana
tenable_noun	mAnya/warkasafgawa
tenacity_noun	xqDawA/lagana
tenancy_noun	kASwakArI/afBaXqwi_(viXi)_kirAexArI
tenant_noun	kASwakAra/kirAexAra
tendency_noun	ruJAna/pravqfwwa
tender_noun	teMdara/nivixA/teMdara_xenA/praswuwa_karanA
tenderer_noun	teMdaraxAwA/nivixAkAra
tenement_noun	vAsagqha/koTarI
tenet_noun	kArmika_sixXAnwa/niyama
tension_noun	wanAva
tentative_noun	ananwima
tenure_noun	avaXi/kAryakAla/pattA/BUXqwi
term_noun	avaXi/miyAxa_Sabxa
terminable_noun	samApanIya/samApya
termination_noun	samApwi
terminology_noun	SabxAvalI
terminus_noun	tarminasa/anwaka
terms_noun	nibanXana
territory_noun	rAjyakRewra
terror_noun	Awafka
terrorist_noun	AwafkavAxI
tertiary_noun	wqwIyaka
test_noun	parIkRaNa/paraKa/jAca
testament_noun	vasIyawa
testamentary_noun	vasIyawI
tester_noun	parIkRaka
testify_noun	sAkya_xenA/pramANiwa_karanA
testimonial_noun	SaMsApawra
testimony_noun	sAkya
texicologist_noun	viRavijFAnI
text_noun	kalevara/majamUna_(pawra)/pATa
thankful_noun	kqwaFjFa
theme_noun	viRayavaswu
therapeutist_noun	cikiwsAvijFAnI
therapy_noun	cikiwsA
thermometer_noun	WarmAmItara/wApamApI
thesis_noun	SoXa_prabanXa/sWApanA
thoroughly_noun	pUrNawayA/sAfgopAfga
thoughtful_noun	vicAraSIla
threat_noun	XamakI/ASafkA/KawarA
threaten_noun	XamakI_xenA/XamakAnA
threatre_noun	rafgaSAlA/nAtyaSAlA/nAtyagqha
thrift_noun	miwavyaya/miwavyayawA
through_noun	xvArA/mAXyama_se_sIXA/pAragAmI
thumb_noun	agUTA
ticket_noun	tikata
tie_noun	bAXanA/gATa/barAbarI_(Kela)
tier_noun	swara/tIyara
tillage_noun	jowa/juwAI
tiller_noun	jowane_vAlA
tilt_noun	JukAva
time-barred_noun	kAlAwIwa
time-bound_noun	samayabaxXa
time_noun	samaya/kAla
timing_noun	samaya/samaya-nirXAraNa
tindal_noun	tiMdala
tinsmith_noun	tInakAra
tips_noun	safkewa/baKSISa
title_noun	SIrRaka/KLwAba/paxavI/haka
to_noun	sevA_meM_(pawrAcAra_ke_sanxaBa_meM)/sevA_meM
toilet_noun	SOcAlaya/prasAXana
token_noun	sAfkewika/tokana
tolerant_noun	sahiRNu/sahanaSIla
tone_noun	svara/sura/lahajA
tonnage_noun	tanamAna/tanaBAra/tanaXAriwA
tool_noun	OjAra/upakaraNa
top_noun	SiKara/SIrRa/savocca
topic_noun	prakaraNa/viRaya/prasafga
topmost_noun	savocca
topography_noun	sWalAkqwi
torture_noun	yanwraNA/yAwanA
total_noun	yoga/joda/kula
tough_noun	kadA/kaTora
tour_noun	xOrA
tourism_noun	paryatana
tourist_noun	paryataka
tournament_noun	tUnAmeMta/KelakUxa-prawiyogiwA
township_noun	nagarI
trace_noun	leSa/surAga_KojanA/pawA_lagAnA/anureKaNa
tracer_noun	anureKaka/tresara
tract_noun	BUBAga/ilAkA
traction_noun	karRaNa
tractor_noun	trEktara
trade_noun	vyApAra/vyavasAya
trader_noun	vyApArI
tradesman_noun	xaswakAra_kArIgara
tradition_noun	paramparA
traffic_noun	yAwAyAwa
tragedy_noun	xu:Kaxa_GatanA/wrAsaxI
trail_noun	paxacihna/lakIra
trailer_noun	anuyAna
train_noun	relagAdI/gAdI/trena
trainee_noun	praSikRaNArWIZ
trainer_noun	praSikRaka
training_noun	praSikRaNa/treniMga
trait_noun	lakRaNa
traitor_noun	xeSaxrohI/gaxxAra
tranquility_noun	praSAfnwa
transaction_noun	saFcAlana_sOxA/lena-xena_saMvyavahAra_(viXi)
transcriber_noun	lipyanwarakAra/prawileKaka
transcription_noun	prawileKana/anuleKana_lipyanwaraNa
transfer_noun	baxalI/wabAxalA/sWAnAnwaraNa/anwaraNa/haswAnwaraNa/baxalI_karanA
transformation_noun	rUpAnwaraNa
transhipment_noun	yAnAnwaraNa
transit_noun	safkramaNa/pAragamana/pAravahana
transitional_noun	safkramaNakAlIna
translation_noun	anuvAxa
translator_noun	anuvAxaka
transliteration_noun	lipyanwaraNa
transmission_noun	prasAraNa_pAreRaNa_(dAka-wAra)
transmitter_noun	trAMsamItara
transponder_noun	trAMspoMdara
transport_noun	parivahana
transportation_noun	parivahana
transposition_noun	ulatanA
trap_noun	PanxA/pASa/PasAnA
travel_noun	yAwrA/yAwrA_karanA
tray_noun	tre
treachery_noun	viSvAsaGAwa
treason_noun	rAjaxroha
treasure_noun	KajAnA
treasurer_noun	koRAXyakRa
treasury_noun	koRa/KajAnA
treat_noun	upacAra/vyavahAra_karanA/mAnanA/KAwira
treaty_noun	sanXi
trek_noun	xurgama_yAwrA
trend_noun	pravqfwwa/JukAva
trespass_noun	awicAra/awicAra_karanA
trial_noun	jAca/paraKa/vicAraNa
tribe_noun	janajAwi
tribunal_noun	aXikaraNa
tribute_noun	sammAna/SraxXAFjali
triennial_noun	wrEvAfrRaka
trim_noun	kAta-CAta_karanA
trip_noun	BramaNa_PerA
tripartite_noun	wripakRIya
triple_noun	wripakRIya/wiharA
triplicate_noun	wIna_prawiyA/wIsarI_prawi/wiharA
trolly_noun	trAlI
trollyman_noun	troYlIvAlA
troop_noun	tolI/sEnyaxala
trophy_noun	vEjayanwI/troYPI
troupe_noun	maNdalI
truce_noun	abahAra_(viXi)/yuxXavirAma_sanXi
trust_noun	nyAsa/trasta_viSvAsa
trustee_noun	nyAsI
trustworthiness_noun	viSvaswawA
trustworthy_noun	viSvasanIya
tubewell_noun	nalakUpa
tunnel_noun	surafga
turner_noun	KarAxI/tarnara
turnout_noun	uwpAxa/upasWiwi
turnover_noun	kula_bikrI/paNyAvarwa/Avarwa
turpitude_noun	aXamawA
tutelage_noun	saMrakRaNa
tutor_noun	anuSikRaka
twin_noun	judavA
type_noun	tAipa/CApA/muxraleKa/prarUpa/tafkiwa_karanA/tAipa_karanA
typescript_noun	tAipa_prawi
typewriter_noun	tAiparAitara/tafkiwra
typewriting_noun	tAipakArI/tAipa_karanA/tafkaNa
typical_noun	prarUpI
typing_noun	tafkaNa/tAipiMga
typist_noun	tAipista_lipika
ulterior_noun	gUDa/gupwa_parawara
ultimate_noun	anwima_carama
ultimately_noun	anwawa:
ultimatum_noun	anwima_cewAvanI
ultimo_noun	gawamAsa_kA
umpire_noun	nirNewA/ampAyara/paFca
unaided_noun	a-sahAyawAprApwa
unambiguous_noun	spaRta
unanimity_noun	mawEkya/sarvasammawi
unanimous_noun	ekamawa/sarvasammawa
unassuming_noun	sIXA-sAxA/sahaja
unattached_noun	asambaxXa
unauthorized_noun	aprAXikqwa
unavoidable_noun	aparihArya
unbecoming_noun	aSoBana/aSoBanIya
uncashed_noun	binA_BunAyA
uncertain_noun	aniSciwa
unclaimed_noun	bexAvA/lAvArisa
unclassified_noun	avargIkqwa
uncommon_noun	asAmAnya
uncompromising_noun	mawAgrahI
unconditional_noun	binA_Sarwa/aSarwa
unconfirmed_noun	apuRta
unconstitutional_noun	asAMviXAnika/asaMvEXAnika
uncontested_noun	nirviroXa
uncorroborated_noun	apuRta/asampuRta
undated_noun	xinAfkarahiwa/axinAfkiwa
undefaced_noun	avirUpiwa
under-consumption_noun	alpopaBoga
under-developed_noun	alpavikasiwa
under-estimate_noun	ava-prAkkalana/kama_anumAna
under-production_noun	nyUnowpAxana
under-utilization_noun	nyUna_upayoga
under-valuation_noun	alpamUlyana
under_noun	aXIna/avara/kama/nyUna/alpa
undergraduate_noun	pUrvasnAwaka
underground_noun	BUmigawa/anwaBOMma
underhand_noun	pracCanna
underlined_noun	reKAfkiwa
undersigned_noun	aXohaswAkRarI
understanding_noun	samaJOwA/samaJaxArI
undertake_noun	(BAra_yA_jLmmA)_lenA/vacana_xenA/vacanabaxXa_honA
undertaking_noun	upakrama_vacana/vacanabanXa
undesirable_noun	avAFCanIya
undignified_noun	aSoBanIya/aBaxra/maryAxAhIna
undisputed_noun	nirvivAxa
undivided_noun	aviBAjiwa/aviBawa
undoubtedly_noun	nissanxeha
undue_noun	anuciwa/asamyaka
unearth_noun	pawA_lagAnA/Koja_nikAlanA
uneconomical_noun	alABakara
unemployment_noun	bekArI/berojagArI
uneven_noun	asamawala/asama
unexpected_noun	aprawyASiwa
unexpired_noun	asamApwa
unfair_noun	anuciwa
unfavourable_noun	prawikUla/ananukUla
unfit_noun	ayogya_asvasWa
unforeseen_noun	axqRta/anapekRiwa
unicameral_noun	ekasaxanI
unification_noun	ekIkaraNa
uniform_noun	ekarUpa/eka_samAna/varxIZ
uniformity_noun	ekarUpawA
unilateral_noun	ekapakRIya/ikawaraPA
union_noun	safGa/yUniyana
unionism_noun	safGavAxa
unique_noun	anupama/apUrva
unit_noun	ekaka/mAwraka/ikAI/yUnita
unitary_noun	ekAwmaka/ekIka
united_noun	saMyukwa
unity_noun	ekawA
universal_noun	sArvaBOma/sArvaxeSika/sArvajanIna
university_noun	viSvavixyAlaya
unjust_noun	anyAyapUrNa/anyAyI
unlawful_noun	viXi-virUxXa/gEra-kAnUnI
unlimited_noun	asImiwa
unlisted_noun	asUcIgawa
unloading_noun	BAra_uwAranA/uwAranA
unnatural_noun	aprAkqwika/asvABAvika
unnecessary_noun	anAvaSyaka
unofficial_noun	aSAsanika/aSAsakIya/gEra-sarakArI/anOpacArika
unopposed_noun	nirviroXa
unpopular_noun	alokafpraya
unprecedented_noun	aBUwapUrva
unpredictable_noun	apUrvAnumeya/warafgI_(vyakwi)
unprliamentary_noun	asaMsaxIya/aSiRta
unproductive_noun	anuwpAxaka/anuwpAxI/niRPala
unqualified_noun	aprawibanXa/binA_Sarwa_/ayogya
unquestionable_noun	praSnAwIwa/_asanxigXa
unreasonable_noun	ayukwiyukwa/anuciwa
unrecorded_noun	anafBaliKiwa
unsafe_noun	asurakRiwa
unsatisfactory_noun	asanwoRajanaka
unsecured_noun	aprawiBUwa/prawiBUwi_rahiwa/asurakRiwa
unserviceable_noun	bekAra/anupayojya
unskilled_noun	akuSala
unstable_noun	asWira
unstarred_noun	awArAfkiwa
untenable_noun	asamarWanIya
untouchhability_noun	aspqSyawA/CuACUwa
untrustworthy_noun	aviSvAsya
unwarranted_noun	anaXikqwa/akAraNa/anapekRiwa
unwieldy_noun	xurvaha
unwilling_noun	anicCuka
unworthy_noun	ayogya
updation_noun	axyawanIkaraNa
upgrade_noun	greda_baDAnA/koti_ucca_karanA
upgrading_noun	unnayana
uphold_noun	puRta_karanA/maryAxA_banAe_raKanA
upholsterer_noun	poSiSasAja
upkeep_noun	saBAla/raKaraKAva
uplift_noun	uwWAna
upper_noun	UparI
uppermost_noun	savocca
upright_noun	KadA_saccA/ImAnaxAra
upset_noun	gadabada_kara_xenA/aswavyaswa_honA
urban_noun	nagarIya/SaharI
urbanization_noun	nagarIkaraNa
urgency_noun	awyAvaSyakawA
urgent_noun	wuranwa/avilamba/awyAvaSyaka
usage_noun	prayoga/calana/pracalana_praWA
useful_noun	upayogI
user_noun	upayogakarwA/upaBokwA
usual_noun	sAmAnya/prAyika
usurp_noun	hadapanA
utility_noun	upayogiwA
utilization_noun	upayoga
vacancy_noun	rikwi/rikwawA
vacate_noun	KAlI_karanA
vacation_noun	avakASa/viSrAmAvakASa
vaccinate_noun	tIkA_lagAnA
vaccination_noun	tIkA
vaccinator_noun	tIkA_lagAnevAlA
vaccine_noun	vEksIna/tIkA
vague_noun	aspaRta/niSciwa
valid_noun	viXimAnya/mAnya/vEXa
validation_noun	viXimAnyakaraNa
validity_noun	viXimAnyawA
valuation_noun	bahumUlya/mUlyavAna
value_noun	mUlya
valuer_noun	mUlyAfkaka
vanity_noun	ahammanyawA/GamaNda
variable_noun	parivarwanaSIla/parivarwIZ
variance_noun	anwara/fBannawA
variant_noun	fBanna/prakArAnwara
variation_noun	vifBannawA_parivarwana
variety_noun	kLsma/prakAra/viviXawA
vegetarian_noun	nirAmiRa/SAkAhArI
vehicle_noun	vAhana
vendor_noun	vikrewA
venereologist_noun	rawirogavijFAnI
vengeance_noun	prawiSoXa
ventilate_noun	saMvAwana/afBavyakwa_karanA
venture_noun	uxyama/sAhasa
venue_noun	sWAna/sWala
veracity_noun	sawyavAxiwA/sawyaparakawA
verbal_noun	mOKika
verbatim_noun	SabxaSa:
verdict_noun	aXimawa
verification_noun	sawyApana
vernacular_noun	sWAnIya_BARA/mAwqBARA/janaBARA/xeSI_BARA
version_noun	anuvAxa_rUpa/rUpAnwara/pATa_kaWana
versus_noun	banAma/virUxXa
vessel_noun	jalayAna/powa
vest_noun	nihiwa_honA
vet_noun	punarIkRaNa_karanA
veteran_noun	xIGAnuBavI_XuranXara
veto_noun	vIto/niReXAXikAra
vetting_noun	punarIkRaNa
viability_noun	jIvana_kRamawA/vyavahAryawA
viable_noun	jIvanakRama/vyavahArya
vice-chairman_noun	upAXyakRa/upa-saBApawi
vice-president_noun	uparARtrapawi_upAXyakRa/upa-saBApawi
vice_noun	upa-vyasana_ke_sWAna_para
victimise_noun	paripIdafwa_karanA/sawAnA/wafga_karanA
victory_noun	vijaya
view_noun	xqSya_xqfRta
viewpoint_noun	xqfRtakoNa
views_noun	xqfRtakoNa/mawa
vigilance_noun	sawarkawA/cOkasI
vigorous_noun	joraxAra
vindictive_noun	oja
violate_noun	prawiSoXI
violation_noun	awikramaNa_karanA
violative_noun	awikramaNa
violence_noun	awikramaNakArI
virologist_noun	vAirasavijFAnI
virtue_noun	hiMsA
virtuours_noun	saxguNa
vis-a-vis_noun	vIjA/praveSa-pawra
vis_noun	barAswA
visa_noun	saxguNI
visibility_noun	ke_sAmana/kI_wulanA_meM
visible_noun	xqSyawA
vision_noun	xqfRtagocara
visit_noun	xqfRta/Agamana/vIkRaNa/nirIkRaNa_BeMta/mulAkAwa_AnA/jAnA
visitor_noun	Aganwuka/mulAkAwI/parixarSaka/kulAXyakRa
visual_noun	xqSya/xqfRta
visualize_noun	xqfRtagawa_karanA/anumAna_lagAnA
vital_noun	jIvanAXAra/mahawvapUrNa
vitality_noun	jIvana_Sakwi
vivid_noun	suspaRta
viz._noun	arWAwa/nAmawa:
vocabulary_noun	SabxAvalI/Sabxa-BaNdAra
vocal_noun	muKara
vocalist_noun	gAyaka
vocation_noun	vyavasAya
vocational_noun	vyAvasAyika
voice_noun	AvAja
void_noun	SUnya
volume_noun	Ayawana/mAwrA/parimANa_jilxa/KaNda
voluminous_noun	viSAla/viSAlakAya
voluntary_noun	svEcCika
volunteer_noun	svayaMsevaka
votable_noun	mawaxeya
vote_noun	mawa/vota/mawa_xenA/vota_xenA
voted_noun	xawwamawa
voter_noun	mawaxAwA
voting_noun	mawaxAna
voucher_noun	vAucara
vow_noun	vrawa/prawijFA
voyage_noun	samuxra-yAwrA
vulcanizer_noun	valkanIkAraka
vulgar_noun	aSiRta/aBaxra
vulnerable_noun	suBexya
wage_noun	majaxUrI/majUrI
waive_noun	aXiwyAga_karanA/Coda_xenA
waiver_noun	aXiwyAga
waiving_noun	aXiwyajana/CodanA
walk-in-interview_noun	praveSa_sAkRAwkAra
want_noun	aBAva/kamI/AvaSyakawA
warchouse_noun	BANdAgAra/mAla_goxAma
ward_noun	vArda_prawipAlya
warden_noun	vArdana
warder_noun	vArdara
warn_noun	cewAvanI_xenA
warning_noun	cewAvanI
warrant_noun	vAraNta/aXipawra
warranty_noun	vAraNtI/ASvaswi
wastage_noun	CIjana/barabAxI
wasteland_noun	baFjara_BUmi
watch_noun	GadI/paharA
watcher_noun	praharI/cOkIxAra
watching_noun	nigarAnI_karane_vAlA/hiwapraharI
watchman_noun	cOkIxAra/praharI/vAcamEna
waterman_noun	pAnIvAlA/vAtaramEna
way-bill_noun	mArgapawraka/ravannA
ways_noun	warIke
wealth_noun	Xana
weather_noun	mOsama
weathering_noun	apakRaya
weigh_noun	wolanA
weighman_noun	wolakAra/wulAIkAra
weight_noun	BAra/wOla/boJa/mahawva/bala/bAta
weightage_noun	mahawva/bala/BAra
welcome_noun	svAgawa/svAgawa_karanA
welder_noun	veldara
welfare_noun	kalyANa
well-versed_noun	supravINa
wharf_noun	GAta
wharfage_noun	GAta-BAdA
whereas_noun	jabaki
wherebouts_noun	TOra-TikAnA/awA-pawA
whimsical_noun	sanakI/JakkI
whip_noun	sacewaka
whisper_noun	kAnAPUsI/kAnAPUsI_karanA/PusaPusAnA
whitewashing_noun	saPexI_karanA
whole-time_noun	pUrNakAlika
wholesaler_noun	Woka_vyApArI
wide-ranging_noun	vyApaka
widower_noun	viXura
wild_noun	vanya/jafgalI
wilful_noun	jAnabUJakara
wind-up_noun	samApana/sametanA
wing_noun	pafKa/para/pakRa/skanXa
winner_noun	vijewA
wireless_noun	bewAra
wireman_noun	vAyaramEna
wise_noun	buxi_XamAna
wit_noun	vAk-patuwA
withdrawal_noun	vApasI
withhold_noun	roka_lenA
within_noun	anxara/anwargawa
withstand_noun	sahana_karanA
witness_noun	sAkRI/gavAha
work-charged_noun	kArya-praBAriwa
worker_noun	kAmagAra
working_noun	kAryacAlana/kAryakArI/SramajIvI/vyAvahArika/kAmacalAU_sakriya
workload_noun	kAryaBAra
workman_noun	karmakAra
workmanship_noun	karma-kOSala
works_noun	nirmANa/kArya/safkarma/kqwi/karmaSAlA
worksheet_noun	kArya-pawraka
workshop_noun	varkaSoYpa/karmaSAlA/kAryaSAlA
worsen_noun	baxawara_honA/baxawara_karanA
worth_noun	mUlya/yogyawA
worthless_noun	bekAra
worthy_noun	guNasampanna/yogya
wounded_noun	GAyala
writ_noun	rita
write-up_noun	AleKa
writing_noun	liKAvata/leKa
wrongdoer_noun	xoRakarwA
wrongful_noun	xoRapUrNa/saxoRa
wrongly_noun	galawa_wOra_para/BUla_se
yardstick_noun	mAnaxaNda
year-book_noun	abxa-koSa
year_noun	varRa/sAla
yearly_noun	vAfrRaka/sAlAnA
yes-man_noun	hA_meM_hA_milAne_vAlA
yield_noun	upaja/pExAvAra/labXi
young_noun	nOjavAna/waruNa/bAla
youth_noun	yOvana/yuvA
zeal_noun	joSa/uwsAha
zenith_noun	carama_sImA
zigzag_noun	teDA-meDA
zonal_noun	AFcalika/jonala
zone_noun	jona/aFcala
zoning_noun	jona_banAnA
zoo_noun	cidLyAGara
