A.D.	EdI
AD	EdI
Oct	akwUbara
Perennially	pUre_varRa
Scot-free	binA_sajA_ke
Scurrilously	PUhadapana_se
Sedulously	pariSrama_se
Selectively	cayana_karake
Senselessly	binA_soce
Stateside	amerIkA_kI_waraPa
a-few	kuCa
a-la	kI_SElI_meM
aback	pICe/pICe_kI_ora/hawapraBa
abeam	wiraXA/AdA
abed	biswara_para/biCOne_para
abjectly	xIna-hIna_Dafga_se
ablaze	lapatoM_meM
ably	kuSalawApUrvaka
abnormally	asAmAnya_rUpa_se/asvABAvika_Dafga_se/asAXAraNa_rUpa_se
aboard	savAra/xala_meM/samUha_meM/ke_pAsa/para_savAra
abominably	burI_waraha_se/bekAra_Dafga_se
about	cAro_ora/yahAz-vahAz/pICe/pAsa/lagaBaga/kramAnusAra/jahAz-wahAz/iXara-uXara/iwaswawaH/cArOM_waraPa/cAroM_ora/Asa-pAsa/iXara_uXara/bahuwa_ho_gayA/ke_bAre_meM/Asa_pAsa
above	UzcA/Upara/se_Upara/ke_Upara/isase_Upara
aboveboard	ImAnaxArI_se
abrasively	ragada_ke/karkaSawA_se
abreast	barAbara_meM/sAWa-sAWa/agala-bagala_meM
abroad	vixeSa_meM/Gara_ke_bAhara/cAroM_ora_PElA_huA/pracaliwa
abruptly	Akasmika_rUpa_se/rUKepana_se/aSiRtawA_se/acAnaka_hI/acAnaka
absent-mindedly	Bulakkadapana_se/anamanApana_se
absently	anamane_BAva_se
absolutely	pUrNawaH/pUrNawayA/pUrI_waraha_se/ekaxama/bilkula/bahuwa_hI/abAXa_rUpa_se
abstractedly	anamane_BAva_se
abstractly	anamane_BAva_se
absurdly	bewuke_rUpa_se
absymally	bahuwa_hI_Baxxe_Dafga_se/bahuwa_hI
abundantly	pracurawApUrvaka/aXika_mAwrA_meM
abusively	galawa_warIke_se/galawa_Dafga_se/apamAnajanaka_Dafga_se/anuciwa_Dafga_se
abysmally	bekAra_Dafga_se/bahuwa_hI_BaxxA
academically	SEkRaNika_xqRti_se
accelerando	layavarXana_ke_sAWa
acceptably	TIka-TAka
accidentally	saMyogavaSa/XoKe_se/saMyoga_se/anajAne_meM/acAnaka_hI/acAnaka
accommodatingly	uxArawApUrvaka/anugrAhI_Dafga_se
according	ke_anusAra
accordingly	waxanusAra/parisWiwi_ke_anusAra/PalasvarUpa
accurately	sahI_Dafga_se/sahI-sahI
accusingly	Aropa_lagAwe_hue/aBiyogAwmaka_Dafga_se/aBiyoga_lagAwe_hue
acidly	ruKAI_se
acoustically	XvAnikI_xqRti_se
acrimoniously	katuwApUrNa_Dafga_se
across	ArapAra/waraPa/sAmane/ora/meM_sarvawra/usa_pAra/koI_eka_xiSA_meM/saBI_ora/usa_pAra_se/ke_Upara_yA_sAmane/vahAz_se_yahAz
actively	sakriya_rUpa_se/sakriyawA_se
actually	vAswava_meM/vaswuwaH/sacamuca/vaswuwa:
acutely	wIvrawA_se/wIkRNawA_se/bahuwa_hI_wejIse/bahuwa_hI
ad-hoc	anOpacArika_rUpa_se{binA_kisI_yojanA_ke}
ad-infinitum	binA_anwa_ke
adagio	XIme-XIme/vilambiwa_laya_meM/manxawAla_meM
adamantly	kaTorawA_se/atalawA_se
additionally	isake_awirikwa/isake_awirikwwa/isake_alAvA
adequately	paryApwa_rUpa_meM_/paryApwa_rUpa_se/paryApwa_rUpa_meM
adjacent	pAsa/bagala_meM
adjectivally	viSeRaNa_ke_rUpa_me_prayoga_kiyA_huA/viSeRaNa_ke_rUpa_meM
administratively	praSAsanika_rUpa_se/praSasanikawA_se
admirably	uwwama_rIwi_se/praSaMsanIya_Dafga_se
admiringly	praSaMsApUrvaka/praSaMsApUrNa_Dafga_se
admittedly	svIkAra_karawe_hue/saca_meM
adrift	pICe/iXara-uXara_bahawe_hue
adroitly	kuSalawA_se/xakRawApUrvaka
advantageously	upayukwawA_se/lABaxAyakawA_se/lABapraxa_Dafga_se
adventurously	sAhasapUrNa_Dafga_se
adversely	prawikUla_rUpa_se
advisedly	vicAra_karake/jAnabUJakara
aerially	havAI_mArga_se
aesthetically	sOMxaryaparakawA_se
afar	xUra_se/bahuwa_xUra_waka/xUra_para
affably	suSIlawA_se/sOjanyawApUrvaka/milansArI_se/milanasArI_se
affectedly	xiKAvatI_Dafga_se
affectingly	marmasparSI_Dafga_se/hqxayasparSI_Dafga_se
affectionately	sneha_se
affirmatively	svIkArAwmaka_rUpa_se/hAz_meM
afield	xUra_waka/xUra{Gara_se}
aflame	lapatoM_meM
afresh	naye_sire_se
aft	jahAja_ke_piCale_BAga_ke_pAsa/xumbAla_meM/pIce_kI_waraPa
after	bAxa_meM/pICe/eka_ke_bAxa_eka/bAxa/ke_bAxa/kI_ora/ke_bAre_meM/ke_anusaraNa_para
afternoons	xopahara_meM
afterward	bAxa_meM
afterwards	bAxa_meM/wawpaScAwa
again	Pira_se/xobArA/punaH/Ora_BI/eka_bAra_Pira/xubArA/puna:/lekina_Pira/Pira
against	ke_viruxXa/ke_sahAre/se_alaga
agape	muzha_bAye_hue
aggressively	AkrAmakawA_se
ago	pahale/pahale{bIwA_huA}
agog	uwsuka
agonisingly	haxa_se_jyAxA
agonizingly	bahuwa_aXika/haxa_se_jyAxA
agreeably	sahamawi_se/suKaxa_Dafga_se
aground	BUgraswa
ahead	Age/pahale_se/pahale/BaviRya_meM/Age_kI_ora
aimlessly	niruxxeSyawA_se/lakRyahInawApUrvaka
airily	beparavAhI_se/lAparavAhI_se
airy-fairy	avyavahArika
ajar	aXaKulA
akimbo	kamara_para_hAWa_raKe_hue/kamar_para_hAWa_raKe_hue
alarmingly	KawaranAka_Dafga_se
alfresco	KulI_havA_meM
alias	urPa
alike	samAna_rUpa_se
all	pUrNa_rUpa_se/pUre_wOra_se/oYla/kevala/bahuwa
allegedly	kaWiwa_rUpa_se
allegorically	rUpakAwmaka_Dafga_se
allegro	xruwa_laya_se
almost	lagaBaga/prAyaH/karIba-karIba/aXikawara
aloft	UzcA/Upara/havA_meM
alone	akelA/kevala
along	sAWa/ke_pAsa/eka_Cora_se_xUsare_Cora_waka/Age/Age_baDanA/barAbara_barAbara/ke_xOrAna/ke_kinAre
alongside	ke_pAsa/ke_nikata/bagala_meM/ke_sAWa-sAWa
aloud	jora_se/ucca_svara_meM
alphabetically	varNamAlA_ke_krama_se/varNAnukrama_ke_anusAra
already	pahale_se_hI/pahale_hI/aBI_waka/pahale_se
alright	TIka/beSaka/bilkula_sahI
also	BI/Ora/isake_sAWa_hI
alternately	bArI-bArI_se/eka_ke_bAxa_eka
alternatively	ke_baxale_meM/vikalpawa
altogether	pUrNarupa_se/saba_milAkara/pUrNawayA/kula_milAkara
altruistically	nisvArWa_BAva_se
always	hameSA/saxEva/saxA/kaBI_BI
amateurishly	SOkiyA_wOra_para
amazingly	AScaryajanaka_rUpa_se
ambiguously	sanxigXawaH/aspaRtawaH/anekArWI_Dafga_se
ambitiously	mahawvAkAfkRA_se
amen	waWAswu/EsA_hI_ho
amiably	snehaSIlawA_se
amicably	mEwrIpUrNa_Dafga_se
amid	ke_bIca/bIca_meM_hI
amidships	jahAja_ke_maXya_meM/powamaXya_meM
amidst	ke_bIca
amiss	galawa/gadabada
amok	pAgala_kI_waraha
among	ke_bIca_meM/milakara/meM_se/meM/ke_sAWa-sAWa/ke_bIca_mez/ke_bIca/maXya_meM
amongst	ke_bIca_meM
amorously	kAmukawA_se
amply	paryApwa_rUpa_se/pracura_mAwrA_meM
amusingly	manoraFjaka_rUpa_se/manoraFjaka_Dafga_se
analytically	viSleRaNAwmaka_rUpa_se
anatomically	SArIrika_rUpa_se
anew	naye_prakAra_se/naye_sire_se
angrily	kroXa_se/gusse_meM
animatedly	joSa_meM
annually	vArRika_meM/sAlAnA/prawi_varRa/hara_sAla
anon	jalxI_hI
anonymously	gumanAma_rUpa_se
anti	ke_viroXI
anticlockwise	vAmAvarwwa
anxiously	uxvega_se/ciMwiwa_hokara
any	kisI_BI_sWiwi_meM/kisI_BI/bilkula/aba_Ora
anyhow	kisI_prakAra_se/Pira_BI/kisI_BI_waraha/jo_kuCa_BI_ho/isake_awirikwa/hara_hAlawa_meM/cAhe_jEse
anymore	isake_bAxa/aba
anyplace	koI_BI_sWAna/kahIM_BI
anyway	kEse_BI/Pira_BI/cAhe_jEse/BI
anywhere	kahIM_BI/kahIM
apace	SIGrawA_se/wIvra_gawi_se/wejI_se
apart-from	alAvA
apart	pqWaka/xUrI_para/xUra-xUra/xUra/tukade-tukade/Codakara/alaga-alaga/alaga
apathetically	uxAsInawA_se
apiece	prawyeka
apologetically	KexasUcaka_Dafga_se
appallingly	Bayafkara_rUpa_se/BayAvaha_rUpa_se
apparently	UparI_wOra_se/spaRta_rUpa_se/prakata_rUpa_se/bilkula/ABAsa_se
appealingly	yAcanA_karawe_hue/anuroXapUrNa_Dafga_se/AkarRaka_rUpa_se
appreciably	paryApwa_rUpa_se/kAPI
appreciatively	kqwajFawApUrvaka
apprehensively	darapUrvaka/ASafkiwa_hokara
appropriately	uciwa_rUpa_se/upayukwa_rUpa_se/TIka_Dafga_se
approvingly	sahamawi_meM
approx	lagaBaga
approximately	lagaBaga/wakarIbana_rUpa_se
apropos	sahI_samaya_para/ke_viRaya_meM
aptly	samuciwa_rUpa_se/kuSalawApUrvaka
arbitarily	manamAne_rUpa_se
arbitrarily	manamAne_Dafga_se/kramahInawaH/avyavasWiwawaH/akramawaH
architecturally	vAswuSilpIya_xqRti_se
archly	kutilawA_se
ardently	prabala_rUpa_se
arguably	vivAxAspaxa_rUpa_se
aright	sahI/TIka_se
around	lagaBaga/cAro_ora/GerevAlA/yahAz-vahAz/upalabXa/sAre/pUre/pICe/jahAz-wahAz/iXar-uXara/iwaswawH/cAroM_ora/Asa-pAsa/hara_ora/iXara_uXara/kuCa_nahIM_karawe_hue/mOjUxa_honA/Asa_pAsa/pICe_kI_ora/waka/meM_yahAz-vahAz/ke_pasa/ke_cAroM_ora/cAroM_waraPa/GUma_kara
arrogantly	GamaNda_se/sagarva/sABimAna/aBimAnapUrvaka
artfully	XUrwawA_se/kuSalawA_se/cAlAkI_se
artificially	kqwrima_rUpa_se
artistically	kalAwmaka_Daga_se
as	pahale_kI_waraha/mAno/kI_waraha/ke_rUpa_meM/jyoMhI/jisa_waraha/jEse_hI/jaba_ki/ke_jEsA/ke_BAnwi/ke_samAna
ashore	wata_para/sWala_para/kinAre_para
aside	eke_ora/eka_waraPa/eka_kinAre/Codakara/alaga/raxxa_karanA/alaga_raKanA
askance	sanxeha_se
askew	wiraCA
assertively	xqDawA_se/xqDawA_ke_sAWa
assiduously	mehanawa_se/pariSramapUrvaka
assuredly	niSciwa_rUpa_se
astern	pICe_kI_waraPa/jahAja_ke_pICe_ke_BAga_me
astir	KalabalI
astonishingly	AScaryajanaka_Dafga_se
astride	tAzgeM_PElA_kara/Ara-pAra/xono_waraPa
astronomically	bahuha_hI
astutely	samaJaxArI_se
asunder	tukade-tukade
asymmetrically	asamamiwIya_Dafga_se
at-once	wuranwa
at	para/se/meM/kI_avasWA_meM/ke_yahAz/ko/kI_ora
athwart	AdA
atleast	kama_se_kama
atop	ke_Upara/sira_ke_Upara
atrociously	haxa_se_jyAxA/bekAra_Dafga_se/Baxxe_Dafga_se/awyaXika
attentively	XyAnapUrvaka
attractively	AkarRaka_rUpa_se
attributively	guNavAcaka_rUpa_meM
atypically	asAmAnya_rUpa_se
audaciously	xuHsAhasapUrvaka
audibly	spaRta_rUpa_se
aurally	karNagocara_rUpa_meM
auspiciously	SuBa_Dafga_se
austerely	AdambarahIna_Dafga_se
authentically	prAmANika_rUpa_se
authoritatively	sAXikAra/AXikArika_rUpa_se/aXikArawaH/aXikArapUrvaka
autocratically	svecCAcArI_Dafga_se
automatically	apane_Apa_se
autonomously	svAyawwawA_se
avidly	uwsukawA_se/uwsukawApUrvaka
avowedly	spaRta_rUpa_se
away	xUra/viroXI_ke_yahAz/pUrI_waraha_se/lagAwAra/alaga/bAhara
awesomely	vismaya_se/Baya_se
awfully	bahuwa_jyAxA/bekAra_Dafga_se/bahuwa
awhile	WodI_xera_ke_lie/kuCa_xera_ke_lie
awkwardly	atapate_Dafga_se
awry	gadabada/ulata-pulata/aswa-vyaswa/teDA
aye	saxA
back-to-back	Age-pICe
back	vApasa/punaH/Pira/pICe_kI_waraPa/pICe_kI_ora/pICe/pahale/javAba_meM/baxale_meM/awIwa_kAla_meM/niyanwraNa_meM
backmost	sabase_pICe_kA
backstage	nepaWya_meM/gupwa_rUpa_se
backward	ultA/pICe_kI_ora/awIwa_kAla_meM
backwards	pICe_kI_ora/ulte/pICe
bad	bahuwa
badly	burI_waraha_se/xuRtawA_se/bahuwa_KarAba/bahuwa_hI/bahuwa_burI_waraha/bahuwa_aXika/asaPalawApUrvaka
baldly	sAPa-sAPa
balefully	XamakI_Bare_Dafga_se
balmily	pAgaloM_kI_waraha_se
bang	TIka/sIXe/purI_waraha_se/acAnaka_Ora_jora_se
bar	ko_Coda_kara
barbarously	SiRtAcArahInawaH/aSiRtawaH/asaByawaH
bareback	binA_jIna_kase_Gode_para
barefoot	nafge_pAzva
barefooted	nafge_pAzva_se/nafge_pAzva
barely	muSkila_se/spaRtawayA/sAPa-sAPa/nAmamAwra_ko/mAtra/kevala/mAwra
barring	ke_alAvA/ko_Codakara
basely	kamInepana_se
bashfully	SarmAwA_huA
basically	mUlawaH/svaBAvawaH/mUla_rUpa_se
beautifully	sunxara_Dafga_se/bahuwa_acCe_se
because	vajaha_se/kyoM_ki/ke_kAraNa
before	ke_pahale/sAmane/pahale_se_hI/pahale_se/pahale/Age/ke_Age/ke_sAmane
beforehand	pahale_se/pahale_se_hI/pahale_hI
beggarly	BiKARiyoM_ke_samAna/BIKa_kI_waraha
beguilingly	mohaka_kiMwu_TagapUrNa_warIke_se
behind	xera_se/pITapara/pICe_kI_Ora/pICe/pICe_se/ke_pICe/ke_samarWana_me/ke_pakSa_me
believably	viSvasanIya_Dafga_se
below	ke_nIce/se_nIce
beneath	nIce_kI_Ora/nIce/ke_nIce/se_nIce/ke_yogya
beseechingly	prArWanA_karawe_hue/manuhAra_karawe_hue
beside	se_hatA_huA/samIpa/nIkata/kI_wulanA_meM/bagala_meM/alaga/pAsa
besides	ke_awirikwa/isake_awirikwa/BI/ko_Codakara/ke_awirikwa_BI/isake_alAvA/ke_alAvA
best	saba_se_acCA/bahuwa_accI_waraha_se/sabase_acCA
better	behawara_warIke_se
between	ke_bIca/bIca_meM/bIca/ke_bIca_meM/ke_bIc
bewilderingly	hakkA-bakkA_ho_kara
beyond	ke_alAvA/ke_Age/Age/ke_pAra/ke_bAxa/ke_bAhara/ke_awirikwa
bias	wiraCA
big	SeKI_mArawe_hue/saPalawApUrvaka
bigamously	xvivEvAhika_warIke_se
bitter	bahuwa_jyAxA
bitterly	kaduvAhata_ke_sAWa/PUta-PUta_kara/bahuwa_jyAxA/kasa_ke/aXika
biweekly	arxXasApwAhika
blankly	BAvaSUnya_xqRti_se
blasphemously	Isa_niMxAwmaka_Dafga_se
bleakly	nirASApUrNa_Dafga_se
blearily	XuzXalI_AzKoM_se
blind	binA_soce_samaJe/anXAXunXa
blissfully	suKaxa_rUpa_se
blithely	prasannawApUrvaka
bloody	pUrNawaH/PAlawu/bahuwa_hI
blunderingly	galawI_se
bluntly	binA_kisI_banAvata_ke/sAPa-sAPa
blusteringly	SeKI_mArawe_hue
boastfully	dIMga_mArawe_hue
bodily	pUrI_waraha_se/kasakara/bala_pUrvaka
bodingly	Saguna_se
boisterously	joSapUrNa_Dafga_se
boldly	sAhasapUrvaka/nidarawApUrvaka
bolt	TIka
boorishly	SiRtAcArahInawaH/aSiRtawaH/asaByawApUrvaka/asaByawaH
boot	isake_awirikwa/BI
bounteously	pracurawApUrvak
bountifully	pracurawApUrvak
brashly	DiTAI_se
bravely	bahAxurI_se
brazenly	DiTAI_se
breathlessly	hAzPAwe_hue
breathtakingly	asAXAraNa_rUpa_se
breezily	prasannaciwwa_Dafga_se
briefly	safkRepa_meM/kuCa_samaya
bright	ulhAsapUrvaka/spaRta_rUpa_se/Ananxa_se
brightly	ullasiwa_ho_kara/ujjvalawA_se
brilliantly	prawiBASAlI_Dafga_se/prakASa_biKerawe_hue
briskly	wejI_se
broad	pUrNawaH
broadcast	PElAkAra/cAroM_ora/PeMka_kara
broadly	mote_wOra_para/viswIrNawA_se/Kula_kara
broodily	avasAxagraswa_Dafga_se
brusquely	rUKepana_se/ruKAI_se
brutally	krUrawA_se/nirxayawA_se
brutishly	paSu_ki_waraha_se
bumptiously	akKadapana_se
buoyantly	praPullawApUrvaka
bureaucratically	nOkaraSAhI_viXi_se
busily	vyaswawApUrvaka
but	yUEYhI/wo_BI/sivAya/sirPa/sAmanyawaH/Pira_BI/lekina/kevala/Codakara/balki/paranwu/magara/kiMwu/ke_awirikwa
by	samIpa/se_hokara/pAsa_meM/pAsa/nikata/najaxIka/ke_nikata/bagala_se/bagala_meM/xvArA/waka/se/meM/ke_xvArA/ke_jarie/ke_Biwara/ke_anusAra/sAWa_meM
bye	alavixA
callously	saMvexanAhIna_Dafga_se
calmly	SAnwI_se/SAnwipUrvaka
cannily	hoSiyArI_se
capably	sakRamawA_se/kuSalawApUrvaka
careful	sAvaXAnI_se
carefully	sAvaXAnI_se/vicAriwawaH/vicArapUrvaka
carelessly	lAparavAhI_se/XyAnahInawaH/asAvaXAnawaH
casually	yUz_hI/sAxe_Dafga_se/saMyoga_se{binA_viSeRa_kAraNa}/sAXAraNa_Dafga_se{binA_viSeRa_vicAra_kie}
catastrophically	anarWakArI_rUpa_se
categorically	spaRta_rUpa_se
caustically	wIKepana_se
cautiously	sawarkawApUrvaka
ceaselessly	niranwara
censoriously	AlocanAwmaka_Dafga_se
centrally	keMxra_meM
ceremonially	rivAja_ke_anusAra
ceremoniously	OpacArika_Dafga_se
certainly	niSciwa_rUpa_se/niSicawa_rUpa_seM
chaotically	avyavasWiwa_Dafga_se
characteristically	KAsa_anxAja_meM
charitably	uxArawA_se
chastely	paviwrawApUrvaka
chattily	bAwUnI_Dafga_se
cheap	kama_kImawa_para
cheaply	saswe_meM
cheekily	guswAKI_se
cheerfully	KuSI-KuSI
cheerily	prasannawApUrvaka
chemically	rAsAyanika_Dafga_se
chiefly	praXAnawaH/sarvopari/muKya_rUpa_seM
chop-chop	jalxI
chronologically	kAlAnukrama_se
chummily	GniRTawA_se
circa	lagaBaga
circumspectly	sAvaXAnIpUrvaka
circumstantially	parisWiwiyoM_ke_AXAra_para/akasmAwa/acAnaka_hI
civilisedly	SiRtawaH/SiRtAcArapUrvaka/SAlInawaH/saByawaH/bASaUra
civilizedly	SiRtawaH/SiRtAcArapUrvaka/SAlInawaH/saByawaH/bASaUra
clean	sAPa_Dafga_se/pUrI_waraha_se/pUrI_waraha/nyAyasafgawa/ekaxama/acCI_waraha_se/aCce_Dafga_se/nissanxeha
cleanly	binA_koI_galawI_se/ImAnaxArI_se/AsAnI_se
clear-headedly	samaJaxArI_se
clear	spaRtawayA/sAPa-sAPa/pUrI_waraha_se/samaJa_meM_AnA
clearly	spaRtawaH/sAPa_sAPa/ni:_sanxeha/niHsanxeha/sAPa-sAPa
cleverly	hoSiyArI_se
climatically	jalavAyu_ke_AXAra_para
clockwise	xakRiNAvarwa/GadI_kI_suI_kI_xiSA_meM
close	pAsa/sawarkawApUrvaka/najaxIka/kasakara/AsapAsa/pAsa_meM
closely	nikatawA_se/XyAnapUrvaka/nikata_se/GaniRTa_rUpa_se/XyAna_se
clumsily	PUhada_Dafga_se
co-operatively	sahayogapUrvaka
coarsely	motA_Ora_BArI
cogently	akAtyawApUrvaka
coherently	saMsakwawA_se
cohesively	saMsajakawA_se
coincidentally	saMyoga_se/saMyogavaSa
cold	pUrI_waraha_se/binA_wEyArI_ke/beparavAhI_se
coldly	binA_uwsAha_ke/ruKAI_se
collaboratively	sahayoga_se
collectively	sAmUhika_rUpa_se
colloquially	bolacAla_kI_BARA_meM
comfortable	ArAma_se
commercially	vyAvasAyika_rUpa_se
commonly	sAmAnyawaH/GatiyA_wOra_para/Ama_wOra_se/aksara/sAXAraNawaH
communally	sAmuxAyika_rUpa_se
comparatively	wulanAwmaka_rUpa_se
compassionately	xayA_ke_sAWa
competently	kuSalawApUrvaka
complacently	AwmatuRtipUrvaka
complete	pUrI_waraha_se
completely	pUrI_waraha_se
compulsively	bAXya_ho_kara
conceitedly	ahafkArapUrvaka
conceivably	samBAviwa_rUpa_se
concernedly	uxvignawApUrvaka/uxvignawaH/ciMwiwawaH/ciMwiwa_ho_kara
concerning	ke_anusAra/ke_bAre_meM
concisely	safkRipwa_rUpa_se
conclusively	niScayAwmaka_rUpa_se
concurrently	sAWa-sAWa
condescendingly	prowsAhaka_Dafga_se
conditionally	SarwoM_ke_AXAra_para
confessedly	niSciwa_rUpa_se
confidentially	gupwa_rUpa_se
confidently	viSvAsa_sahiwa
confidingly	viSvAsa_prakata_karawe_hue
confoundedly	hErAnI_se/BOMcakkA_ho_kara
confusedly	samBramiwa_ho_kara/sanxigXawaH/aspaRtawaH
confusingly	samBramiwa_karawe_hue/sanxigXawaH/aspaRtawaH
conscientiously	niRTApUrvaka/ImAnaxArI_se
consecutively	krama_se/kramAnusAra
consequentially	pariNAmasvarUpa
consequently	PalasvarUpa/pariNAmasvarUpa/awaH/isake_pariNAma_svarUpa/isalie
conservatively	xakiyAnUsI_Dafga_se
considerably	bahuwa_aXikawA_se/awyAXika
considerately	XyAna_raKawe_hue
considering	yaha_xeKawe_hue/XyAna_meM_raKa_kara
consistently	lagAwAra
conspicuously	suspaRta_rUpa_se/praXAna_rUpa_se
conspiratorially	RadyanwrapUrNa_Dafga_se
constantly	lagAwAra/saxA
constitutionally	samvEXAnika_rUpa_se
contagiously	safkrAmaka_rUpa_se
contemporaneously	usI_samaya
contemptuously	wiraskArapUrvaka
contentedly	sanwuRtipUrvaka
contextually	prasafga_ke_AXAra_para
continually	niranwara/lagAwAra
continuously	lagAwAra
contractually	saMvixA_ke_wahawa
contrariwise	viparIwa_krama_se/vilomawaH
contribution	leKa_Axi
contritely	paScAwwApapUrvaka/KexapUrvaka
contumaciously	vixrohAwmaka_Dafga_se
contumeliously	avajFApUrvaka
conveniently	suviXAjanaka_Dafga_se/AsAnI_se
conveniniently	suviXApUrvaka
conventionally	paramparAgawa_Dafga_se
conversely	isake_viparIwa/ulatA
cool	SAnwipUrvaka
coolly	SAnwi_se/uxAsInawApUrvaka
cooperatively	sahayogapUrvaka
copiously	aXikawA_se/pracurawApUrvaka
cordially	SiRtawaH/SiRtAcArapUrvaka/SAlInawaH/saByawaH/hArxika_rUpa_se/bASaUra/awyaXika
correctly	sahI_Dafga_se
correspondingly	pariNAmasvarUpa
corruptly	BraRta_warIke_se
cosily	ArAma_se
cosmetically	prasAXana_ke_wOra_para
counter-clockwise	ultI_xiSA_meM
counter	viparIwa/viparIwa_xiSA_meM
country-wide	xeSa_Bara_meM
courageously	sAhasa_se
course	avaSya
courteously	SiRtawApUrvaka
covertly	cupake_se
covetously	lAlaca_meM[ke_sAWa]
cowardly	kAyarawA_se/bujaxilI_se
coyly	naKare_se
cracking	bahuwa_hI
craftily	XUrwawApUrvaka
crash	kadakadAkara/cUra_cUra_hokara
crassly	mUrKawApUrNa_Dafga_se
creatively	racanAwmaka_rUpa_se
credibily	viSvasanIya_suwra_se
credibly	viSvAsa_ke_sAWa/viSvasanIya_Dafga_se
creditably	praSaMsanIya_rUpa_se
criminally	aparAXI_hone_ke_AXAra_para
crisply	spaRtawApUrvaka_Ora_safkRepa_meM/kurakure_Dafga_se
crookedly	wiraCepana_se/kutilawA_se
cross-country	Cote_rAswe_se
cross-legged	pAlaWI_mAre_hue/pAlaWI_mArakara
crosswise	Ade-wiraCe
crouched	xubaka_kara
crucially	awyAvaSyaka_rUpa_se
crudely	ruKAI_se/anagaDa_warIke_se
cruel	nirxayawA_se/krUrawA_se
cruelly	nirxayawApUrvaka/krUrawApUrvaka
crushingly	kaTorawApUrvaka
cryptically	rahasyamaya_Dafga_se
culpably	AparAXika_Dafga_se
culturally	sAMskqwika_rUpa_se
culvert	KE_SawA
cum	evaM
cunningly	cAlAkI_se/KUbasUrawI_se
currently	Aja-kala/varwamAna_meM/isa_samaya/Ajakala
cursorily	sarasarI
curtly	ruKAI_se
customarily	sAXAraNawayA
cyclically	AvarwI_Dafga_se
cynically	vyafgyapUrvaka
daftly	pAgaloM_kI_waraha_se
daily	prawixina/hameSA/prawi_xina/prawi_xivasa
damn	bahuwa_hI/bahuwa
damnably	bahuwa_jyAxA
damply	gIlA_ho_karaA
dangerously	KawaranAka_warIke_se
darkly	XamakI_Bare_anxAja_meM/gaharI_uxAsI_se/binA_prakASa_ke
dashingly	AkarRaka_Dafga_se
dauntingly	Bayapraxa_rUpa_se
daylong	xina_Bara
dazzlingly	AScaryajanaka_rUpa_se
dead	pUrNawayA/pUrI_waraha_se/bahuwa/acAnaka_hI/acAnaka
deadly	mOwa_sA/bahuwa_hI
deafeningly	bahuwa_weja
dear	uzcI_kImawa_meM/bahuwa_pyArA
dearly	prema_se/bahuwa_aXika/bade_mola_para/mahafge_xAma_para/bahuwa_jyAxA
deathly	mqwyuvaw
deceitfully	kapatapUrNa_Dafga_se
decently	SAlInawA_se/SAlInawApUrvaka/sahI_Dafga_se
deceptively	kapata_se/BrAmaka_rUpa_se
decidedly	niSciwa_rUpa_se
decisively	niScaya_ke_sAWa/nirNayAwmaka_Dafga_se
decorously	sunxarawA_se/SAlInawA_se
deep	gaharA/xUra_waka/gaharAI_meM/gaharAI_se[meM]
deeply	gaharApana/gaharAI_meM/gaharA/bahuwa_hI/bahuwa_aXika
defacto	vaswuwa:
defectively	wruti/KarAba_warIke_se
defencelessly	rakRA_ke_binA/asahAya_Dafga_se
defensively	prawirakRAwmaka_Dafga_se/AwmarakRAwmaka_Dafga_se
deferentially	AxarapUrvaka/sammAnapUrvaka/jIhujUriyApana_se
defiantly	avajFApUrvaka
definitely	pakkA_karanA/niSciwa_rUpa_se/spaRtawA_se/jarUra
definitively	sWirawApUrvaka
dejectedly	uxAsI_ke_sAWa/uxAsa_BAva_se
deliberately	jAnabUJa_kara/jAna-bUJa_kara
delicately	kuSalawApUrvaka
deliciously	svAxa_lewe_huye
delightedly	KuSI_se
delightfully	KuSI_se/rucikara_Dafga_se/KUbI_se
deliriously	unmawwawA_se/unmAxI_kI_BAzwi/pralApI_kI_waraha
delusively	BrAmaka_rUpa_se
demandingly	bahuwa_aXika_apekRA_raKawe_hue
dementedly	pAgalapana_se/pAgaloM_kI_waraha
democratically	prajAwAnwrika_rUpa_se/prajAwAnwrika_Dafga_se
demonstrably	pramANya_rUpa_se
demonstratively	praxarSana_karawe_hue
demurely	gamBIrawApUrvaka
densely	saGanawApUrvaka/bevakUPI_se
dependably	viSvasanIya_Dafga_se
dependently	parAXInawaH/paravaSawaH
deplorably	xuHKaxa_Dafga_se/burI_waraha_se
derisively	upahAsapUrNa_Dafga_se
deservedly	nyAyawaH/uciwa_rIwa_se
designedly	jAna-bUJa_kara
despairingly	nirASApUrvaka
desperately	awyAvaSyakawApUrvaka/ASAhIna_ho_kara_xuHsAhasapUrvaka
despicably	GqNiwa_rUpa_se
despite	ke_bAvajUxa/hone_para_BI
despondently	nirASApUrvaka
destructively	vinASakArI_Dafga_se
desultorily	asafgawa_Dafga_se
determinedly	xqDa_niScaya_ke_sAWa
detrimentally	hAnikAraka_rUpa_se
devastatingly	praBAvaSAlI_Dafga_se
devilishly	bahuwa_aXika
deviously	cAlAkI_se/kutilawA_se
devoutly	XarmaparAyaNawA_se
dexterously	xakRawApUrvaka
dextrously	xakRawApUrvaka
diabolically	SEwAnI_rUpa_se
diagonally	vikarNawaH/wiraCA
diagrammatically	Akqwi_xvArA
diametrically	pUrNa_rUpa_se/pUrNawayA
dictatorially	wAnASAha_kI_waraha
didactically	SikRAwmaka_rUpa_se/SEkRaNika_xqRti_se
differently	alaga_prakAra_se/alaga-alaga
diffidently	safkocapUrvaka
diligently	mehanawa_se
dimly	sanxigXawaH/PIke_Dafga_se/manxa_rUpa_se/aspaRtawaH
diplomatically	vyavahArakuSalawA_se/rAjanayika_rUpa_se
direct	sIXA/prawyakRawaH/binA_ruke
directly	sIXe_se/spaRtawaH/spaRta_rUpa_se/sIXe/jalxI
dirty	bahuwa
disadvantageously	alABakara_Dafga_se
disappointingly	nirASAjanaka_Dafga_se
disarmingly	SAnwa_karawA_huA
disastrously	xurBAgyapUrNa_Dafga_se
disbelievingly	aviSvAsapUrNa_Dafga_se
disconcertingly	vikRubXa_karane_ke_Dafga_se
disconsolately	nirASApUrNa_Dafga_se
discontentedly	asanwuRta_Damga_se
discordantly	besure_Dafga_se
discouragingly	niruwsAhiwa_karawA_huA
discourteously	aBaxrawApUrvaka/aSiRtApUrvaka
discreetly	sAvaXAnI_se
discretely	alaga_se
disdainfully	avajFApUrvaka
disgracefully	lajjAjanaka_Dafga_se
disgustedly	GqNApUrvaka/ciDa_kara
disgustingly	GqNiwa_rUpa_se/bahuwa_aXika
dishonestly	beImAnI_se
dishonorably	niMxanIya_Dafga_se
dishonourably	apamAna_se/niMxanIya_Dafga_se
disjointedly	asambaxXa_Dafga_se
dismally	nirASAjanaka_Dafga_se
dismayingly	nirASAwmaka_rUpa_se
dismissively	upekRApUrNa_Dafga_se
disobediently	avajFApUrNa_Dafga_se
disparagingly	apamAnajanaka_Dafga_se
dispassionately	niRpakRa_rUpa_se
disproportionately	asafgawi_se
disquietingly	becEna_karawA_huA
disregarded	BulA_kara
disregarding	najaranxAja_karawe_hue/kI_paravAha_kie_binA
disrespectfully	anAxaraNIyawA_se/nirAxarapUrNa_Dafga_se
distantly	xUra_se
distastefully	arucikara_Dafga_se
distinctively	viSiRta_rUpa_se
distractedly	anyamanaska_Dafga_se
distressingly	xuHKaxa_rUpa_se/aprIwikara_Dafga_se
disturbingly	vyAkulawA_uwpanna_karawe_hue
diversely	Binna_prakAra_se
divinely	xEvika_rUpa_se
divisively	PUta_dAlane_ke_Dafga_se
dizzily	cakkara_se_AkrAnwa_ho_kara
docilely	sahajawA_se
doctrinally	mawa_ke_AXAra_para
doggedly	xqDa_niScaya_ke_sAWa
dogmatically	mawAnXa_rUpa_se
dolefully	KinnawApUrvaka
domestically	Anwarika_rUpa_se
dominantly	prabala_rUpa_se
dopey	naSe_meM
dottily	pAgaloM_kI_waraha_se
double-quick	bahuwa_jalxI_se
double	xo_bAra/xo_bAgo_meM/xoharA
doubly	xugunA/BalI_BAzwi
doubtfully	sasanxeha/sanxehapUrNa_Dafga_se
doubtless	nisanxeha/nIssanxeha
dourly	rUTa_kara
down-market	saswe_meM
down	nIce/xakRiNonmuKa/purI_waraha_se/nigalakara_SarIra_ke_anxara/nIce_kI_waraPa/kAgaja_para/uxAsa/hawowsAha/KarAba/para/nIce_waka/ke_kinAre/ke_nIce/ke_wale
downhill	DalAna_kI_ora
downright	pUrI_waraha_se
downstairs	sIDI_ke_nIce/nicalI_maFjIla_para
downstream	pravAha_kI_ora
downward	nIce_kI_ora
downwards	nIce_kI_ora
downwind	pavanABimuKa
dramatically	nAtakIya_Dafga_se/nAtakIya_rUpa_se/praBAvaSAlI_warIke_se
drastically	jabarxaswa_rUpa_se
dreadfully	Bazyakara_Dafga_se/burI_waraha_se/bahuwa_aXika
dreamily	svapna_jEsA/svapnila_Dafga_se
drearily	uxAsI_se
drowsily	unIMxe_Dafga_se
drunkenly	SarAbiyoM_kI_waraha
dubiously	sanxigXa_rUpa_se/aniSciwawApUrvaka
due	sIXe
dully	XuzXale_Dafga_se/niruwsAhapUrvaka
duly	uciwa_rIwi_se/yaWAvaw/yaWAsamaya
dumbly	mUrKawApUrNa_Dafga_se/mUka_rUpa_se
during	ke_xOrAna/meM/ke_samaya_meM/ke_samaya
duty-free	binA_kara_ke
dynamically	joSIle_Dafga_se
e.g.	uxAharaNArWa
each-way	xono_waraPa{Sarwa_kA}
each	hara/prawyeka_ke_lie/hara_eka_lie/eka_sAWa
eagerly	vyagrawA_se
earlier	pahale/pahale_[kA]
early	jalxI_se/jalxI
earnestly	xqDawA_se/namrawApUrvaka/ImAnaxArI_se
easily	AsAnI_se/wuranwa/vahI/niHsanxeha
east	pUrva_kI_ora
eastwards	pUraba_xiSA_kI_ora/pUrva_kI_ora
easy	sAvaXAni_se/AhiswA
eccentrically	sanakiyoM_kI_waraha
eclectically	viBinnaxarSanagrAhiwApUrvaka
ecologically	pArisWiwika_rUpa_se
economically	kamaKarce_meM/miwavyayiwApUrvaka/ArWika_rUpa_se
ecstatically	harRonmawwawA_ke_sAWa/AnanxAwirekapUrvaka
edgeways	kinArA_Age_yA_Upara_kI_ora_karake/wiraCA
edgewise	wiraCA
edgily	vyagrawApUrvaka
educationally	SEkRika_rUpa_se
eerily	asvABAvika_BayAnakawApUrNa_Dafga_se
effectively	praBAvakArI_rUpa_se/saPalawApUrvaka/praBAvaSAlI_rUpa_se/praBAvapUrNa_Dafga_se/asala_meM
effectually	praBAvowpAxaka_Dafga_se
efficiently	nipUNawA_se
effortfully	sAyAsa/prayawnawaH/prayawnapUrvaka
effortlessly	saralawA_se/sahaja_rUpa_se
egotistically	sagarva/sABimAna/ahaMmanya_Dafga_se/aBimAnapUrvaka
either	yaha_yA_vaha/BI
elaborately	supariRkqwa_rUpa_se
elatedly	praPullawApUrvaka
electorally	nirvAcakIya_rUpa_se
electrically	vixyuwa_se/vExyuwa_rUpa_se
electronically	ilEktrAna_xvArA/ilektranika_warIke_se
elegantly	surucipUrNa_Dafga_se
elliptically	nyUnapaxIya_Dafga_se
eloquently	arWapUrNa_Dafga_se
else	anya/sivAya/Ora/ke_alAvA/aWavA/anyaWA
elsewhere	Ora_kahIM/anyawra/anawa
elusively	xurgrAhya_rUpa_se
embarrassingly	lajjAjanaka_rUpa_se
eminently	uwkqRta_rUpa_se
emotionally	BAvukawApUrvaka/BAvuka_ho_kara/BAvAwmaka_Dafga_se
emphatically	saSakwa_waraha_se/suspaRta_rUpa_se
empirically	prayogasixXa_waraha_se/anuBavasixXa_DaNga_se
emptily	BAvaSunyawApUrvaka
enchantingly	mohaka_rUpa_se
encouragingly	uwsAhavarXaka_Dafga_se
end-to-end	SurU_se_anwa_waka/AxyopAnwa
endearingly	prIwikara_Dafga_se
endlessly	niranwara/anwahInawA_se
enduringly	cirasWAI_rUpa_se
energetically	praBAvaSAlI_Dafga_se
engagingly	AkarRaka_Dafga_se/luBAvane_Dafga_se
enigmatically	rahasyamaya_Dafga_se
enjoyably	AnanxaxAyaka_Dafga_se
enormously	bahuwa_aXika
enough	paryApwa/kAPI/bohawa_jyAxA
enquiringly	jijFAsApUrvaka
enterprisingly	uwsAhapUrvaka
entertainingly	manoraFjaka_Dafga_se
enthusiastically	uwsAhapUrvaka
enticingly	mohaka_Dafga_se
entirely	sampUrNawayA/pUrI_waraha_se
entreatingly	prArWanA_karawe_hue
enviably	spqhaNIya_rUpa_se
enviously	IrRyA_ke_sAWa
environmentally	paryAvaraNa_kI_xqRti_se
equably	sWirwaciwwApUrvaka
equally	samAna_rUpa_se/sAWa-hI-sAWa
equitably	barAbarI_se
ere	SIGra
ergo	isalie
ergonomically	karmacArI_parisWiwi_vijFAna_ke_anusAra/Srama-xakRawA_kI_xqRti_se
erotically	kAmukawApUrvaka
erratically	aniyamiwa_Dafga_se/aniSciwa_Dafga_se
erroneously	galawI_se/aSuxXawA
especially	viSeRawaH/viSeRa_rUpa_se/KAsa_wOra_para/KAsakara
essentially	wawwvawaH
esthetically	sOMxaryaparakawA_se
etcetera	Axi
eternally	ananwakAla_waka
ethically	nEwika_rUpa_se
ethnically	jAwi_sambanXI
euphemistically	mafgalaBARI_Dafga_se
evasively	tAla-matola_karawe_hue/sanxigXawaH/aspaRtawaH
even	yahAz_waka_kI/TIka_iwanA_hI/Ora_BI/kevala/BI
evenings	hara_SAma_me/SAma_ke_samaya
evenly	samAna_rUpa_se
eventually	anwa_meM/anwawogawvA/anwawaH/AKirakAra
ever	kaBI_BI/saxEva/niwya/niranwara/kaxApi/kaBI/hamesA/iwanA
everlastingly	sarvaxA
evermore	saxEva_ke_lie/hameSA
everyplace	prawyeka_sWAna_para/sarvawra/saBI_jagaha/hara_jagaha
everywhere	sarvawra/sarvatra/saBI_jagAha/jahA_kahI/hara_sWAnapara/hara_jagAha
evidently	spaRta_rUpa_se
evil	pApa/burAI
evilly	xuRtawA_se
ex	BUwapUrva
exactly	bilkula_TIka/TIka_TIka/vAswava_meM/yaWArWawaH
exaggeratedly	awiSayokwipUrNa_Dafga_se
exceedingly	awyanwa/bahuwa_sA
except	ko_Codakara/ko_Coda_kara
exceptionally	viSeRa_rUpa_se/asAXAraNa_rUpa_se/asAmAnya_rUpa_se/apavAxAwmaka_rUpa_se
excessively	awiSaya
excitedly	uwwejiwa_ho_kara
excitingly	uwwejaka_rUpa_se
exclusively	pUrI_waraha_se/kevala
excruciatingly	marmAnwaka_rUpa_se
exhaustively	suviswqwa_rUpa_se
exorbitantly	bahuwa_jyAxA
expansively	TATa_se
expectantly	ASApUrvaka
expensively	aXika_Karca_karake
experimentally	prAyogika_rUpa_se
expertly	suvijFawApUrvaka
explicitly	spaRtawA_se/spaRtawayA
explosively	visPotaka_rUpa_se/acAnaka
exponentially	caraGAwAfkI_rUpa_se
express	wuranwa/wejI_se
expressively	arWapUrNa_Dafga_se
expressly	spaRta_rUpa_se/jAna-bUJa_kara
exquisitely	najAkawa_se
extempore	binA_wEyArI_ke
extensively	vyApaka_rUpa_se/bahuwa_viswqwa_rUpa_se
externally	bAhara_se
extraordinarily	AScaryajanaka_rUpa_se/asAmAnya_Dafga_se
extravagantly	KarcIle_Dafga_se/bahuwa_aXika
extremely	awyaXika/bahuwa_hI/awyAXika
exuberantly	samqxXa_Dafga_se_kiyA_gayA
exultantly	ullasiwa_ho_kara
face-to-face	eka-xUsare_ke_sAmane/Amane-sAmane
facetiously	majAka_meM
facially	cehare_se
factually	waWyoM_ke_AXAra_para
failing	ke_na_hone_para/na_hone_para/ke_aBAva_meM
faintly	sanxigXawaH/aspaRtawaH
fair	sIXA/nyAya_se
fairly	nyAyapUrvaka/TIka_se/pUrI_waraha_se/kAPI_haxa_waka/kAmacalAU_Dafga_se/bahuwa_haxa_waka
faithfully	XyAna_se/viSvasanIya_Dafga_se/viSvasanIya/ImAnaxArI_se
faithlessly	viSvAsaGAwI_Dafga_se/bevaPAI_se
false	bevaPAI_se
falsely	JUTa-mUTa
falteringly	dagamagAwA_huA
famously	yaSasvI_wOra_para/suvixiwa_rUpa_se
fanatically	kattarawApUrvaka
fantastically	AScaryajanaka_rUpa_se
far	xUra/awi/bahuwa
farther-most	awi_xUra
farther	Ora_Age/aXika/Ora_xUra
farthest	sabase_xUra_waka
fast	SIGra/jalxi_se
fastidiously	xuswoRaNIya_Dafga_se
fatalistically	xEvavAxI_Dafga_se
fatally	sAfGAwika_rUpa_se
faultlessly	xoRarahiwa_Dafga_se
favorably	praSaMsAwmaka_Dafga_se
favourably	praSaMsA_kI_xqRti_se/praSaMsAwmaka_Dafga_se
fearfully	Bayasahiwa/BayAvaha_rUpa_se/BayaBIwa_ho_kara
fearlessly	nirBayawApUrvaka/nidarawApUrvaka
federally	safGIya_sarakAra_xvArA
feebly	xurbalawA_se
feelingly	BAvanA_sahiwa
felicitously	Ananxa_se
ferociously	KUzKAra_rUpa_se/ugra_rUpa_se
fervently	uwsukawA_se/uwkatawApUrvaka
fetchingly	AkarRaka_rUpa_se
feverishly	uwwejiwa_avasWA_meM/uwwejanApUrvaka
few	WodA
fiendishly	nIcawA_kI_haxa_karanA
fiercely	pracaNda_rUpa_se/ugrawApUrvaka/barbarawA_se
fifthly	pAzcaveM_sWAna_para/pAzcaveM
fifty-fifty	AXA-AXA
figuratively	AlafkArika_waraha_se/lAkRaNika_rUpa_se
filthy	bahuwa_hI/malina
finally	anwawaH/AKirakAra/anwawogawvA/anwa_meM
financially	ArWika_rUpa_se
fine	bahuwa_acCI/TIka_waraha_se/bahuwa_kama_anwara_honA
finely	sunxarawA_se/sunxarawApUrvaka/sUkRamawApUrvaka/bArIkI_se/sUkRmawA_se
firm	majabUwI_se/sWirawA_honA
firmly	majabUwI_se
first-rate	acCI_hAlawa_meM/awi_uwwama
first	pahalI_bAra/pahale/sabase_pahale/ke_pahale
firsthand	prawyakRa_rUpa_se/prawyakRa
firstly	sabase_pahalA/AramBa_meM
fishily	sanxigXa_rUpa_se
fitfully	vyAkulawA_se/aniyamiwa_Dafga_se
fittingly	upayukwa_rUpa_se
fivefold	pAzca_gunA
fixedly	xqDawApUrvaka
flagrantly	avahelanA_se/KullamaKullA
flamboyantly	ArkaRaka_rUpa_se/BadakIle_Dafga_se
flat	pUrI_waraha_se/nIrasa/besura/girA_xenA/sIXA_raKanA/binA_uwAra_caDAva_ke/anumAniwa
flatly	pUrI_waraha_se/sAPa-sAPa
fleetingly	kRaNa_Bara_ko
flimsily	kamajora_Dafga_se
flippantly	binA_gamBIrawA_ke/CiCorepana_se
flipping	nApasanxagI_xiKAnA
floating-around	iXara_uXara_GUmawe_hue
floridly	AlafkArika_rUpa_se
fluently	binA_rukAvata_ke/XArApravAhiwA_ke_sAWa
following	hone_para
fondly	premapUrvaka/Bolepana_se
foolishly	mUrKawA_se
for	ke_lie/kI_ora_se/ke_hisAba_se/waka
forbiddingly	GqNA_se/darAvane_Dafga_se
forcefully	joraxAra_warIke_se/saSakwa_rUpa_se
forcibly	balapUrvaka
fore	sAmane/Age
foremost	muKyawaH/sarvAXika
forever	saxEva/hameSA_ke_lie/hameSA
forgetfully	Bulakkadapana_se
forlornly	lAcArI_se/xayanIya_BAva_se
formally	OpacArika_rUpa_se/viXivaw_rUpa_se
formerly	vigawa_kAla_meM/pahale_jEse/pahale/isse_pUrva/bIwe_hue_samaya_meM
formidably	xurjeya_rUpa_se
forte	ucca_svara_meM/jora_se
forth	Age/bAhara/Age_kI_ora
forthrightly	spaRta_rUpa_se
forthwith	wuranwa/POrana
fortissimo	jora_se
fortnightly	hara_paKavAde_meM
fortuitously	BAgya_se
fortunately	BAgya_se/sOBAgyavaSa
forward	sAmane/Age/Age_kI_ora
foully	anuciwawA_se/GqNiwa_Dafga_se/anuciwa_Dafga_se
fourfold	cOgunA
foxily	XUrwawApUrvaka
fractionally	WodA_sA/AMSika_rUpa_se
fradulently	kapatapUrNa_Dafga_se
fragrantly	suganXa_se
frankly	niRkapatawA_se/spaRta_rUpa_se/ImAnaxArI_se
frantically	pAgalapana_se/vyagrawApUrvaka
fraternally	BrAwqBAva_se
free	mukwa_Dafga_se/muPwa/binA_mUlya_ke
freehand	mukwahaswa_se
freehold	pUrNa_svAmiwva_se
freelance	svawantra_rUpa_se
freely	mukwa_rUpa_se/Kule_Ama/svawanwra_rUpa_se/svecCA_se/svawanwrawApUrvaka/mukwa_BAva_se
frenetically	awyaXika_uwwejiwa_ho_kara
frenziedly	pAgaloM_kI_waraha
frequently	bahuXA/prAyaH
fresh	aBI-aBI
freshly	XqRtawApUrvaka/DiTAI_se
fretfully	SikAyawI_Dafga_se/cidacidepana_se
friendly	miwrawa_purNa/mEwripUrvaka
frighteningly	BayAvaha_rUpa_se
frightfully	awyanwa/bahuwa_aXika
frigidly	TaNdepana_se
frivolously	asArawApUrvaka
fro	se
from...on	ke_bAxa
from	se/ke/ke_yahAz_se
front	sAmane_kI_ora_se
frontally	sAmane_kI_ora
frostily	ruKAI_se
frothily	JAga_ke_sAWa
frugally	alpavyayiwApUrvaka
fruitfully	lABaxAyaka_rUpa_se/lABakArI_Dafga_se
fruitlessly	nirarWakawA_se
frustratingly	nirASA_se/kuNTAkArI_rUpa_se
fucking	kAPI
full-time	pUrNakAlika
full	TIka/sIXA/pUrI_waraha/acCI_waraha
fully	pUrNa_rUpa_se
functionally	kiyAwmaka_rUpa_se
fundamentally	mUla_sixXAnwa_se/mUlawaH/mUla_rUpa_se/AXAraBUwa_rUpa_se
funnily	ajIba_waraha_se
funny	parihAsamaya
further	Ora/isake_awirikwa/Ora_Age/aXika_viswAra_se/ke_alAvA
furthermore	isake_awirikwa/Upara_se/sAWa_hI_sAWa/isake_alAvA
furthest	sabase_Age
furtively	gupwa_rUpa_se
fussily	GabarAhata_ke_sAWa
fuzzily	sanxigXawaH/aspaRtawaH
gaily	KuSI_se/prasannaciwwa_Dafga_se/lAparavAhI_se/AkarRaka_Dafga_se
gainfully	lABapraxa_rUpa_se
gallantly	bahAxurI_se
galore	pracura_mAwrA_meM
gamely	nidarawA_se/sAhasapUrvaka
garishly	BadakIle_Dafga_se
garrulously	vAcAlawA_se/bAwUnI_Dafga_se
gastronomically	pAka-kalAnusAra/pORtikawA_se
gaudily	BadakIle_Dafga_se
gawkily	ajIba_sA
general	Ama_wOra_para/sAmAnyawayA
generally	vyApaka_rUpa_se/sAmAnyawaya/AmawOra_para/aksara/prAya:/sAXAraNawaH
generically	sAmAnya_rUpa_se/jAwigawa_rUpa_se
generously	uxArawApUrvaka
genetically	AnuvaMSikawA_se/vaMSa_se
genially	milanasAriwA_se
genteelly	aBijAwa_Dafga_se
gently	naramI_se/SiRtawA_se/sAvaXAnI_se/halke_se
genuinely	sacamuca_meM
geographically	BOgolika_rUpa_se
geologically	BUvijFAna_kI_xqRti_se
geometrically	jyAmiwIya_xqRti_se/jyAmiwIya_Dafga_se
gingerly	darawe-darawe
girlishly	kanyAsulaBa_Dafga_se
given	xeKawe_hue
gladly	KuSI_se/svecCA_se/prasanawwApUrvaka/KuSI-KuSI
glamorously	BadakIle_Dafga_se
glaringly	suspaRta_rUpa_se
gleefully	prasannawApUrvaka
glibly	XArApravAha
globally	vyApaka_rUpa_se/sArvaBOmika_rUpa_se
gloomily	uxAsa_ho_kara
glowingly	uwsAhapUrvaka
glumly	uxAsa_ho_kara
good-humouredly	hazsawe_hue
good-naturedly	nekI_se
gorgeously	SAnaxAra_Dafga_se/Bavya_Dafga_se
gracefully	sunxarawA_se/SiRtawaH/SiRtAcArapUrvaka/SAlInawaH/saByawaH/manohara_Dafga_se/bASaUra
gracelessly	Baxxe_Dafga_se/SiRtAcArahInawaH/PUhada_Dafga_se/aSiRtawaH/asaByawaH
graciously	xayA_se/SAlInawApUrvaka
gradually	XIre_XIre/XIre-XIre
grammatically	vyAkaraNa_sammawa_Dafga_se
graphically	suciwriwa_rUpa_se/sajIva_Dafga_se
gratefully	kqwajFawA_se/kqwajFawApUrvaka
gratifyingly	sanwoRajanaka_rUpa_se
gratis	seMwa_mewa
gratuitously	anAvaSyaka_rUpa_se
gravely	gamBIrawA_se/gamBIra_BAva_se
greatly	awyanwa/bahuwa_hI
grievously	kaRtaxAyaka_Dafga_se
grimly	kaTorawA_se
grossly	burI_waraha_se
grotesquely	vikqwa_rUpa_se
grudgingly	hicakicAhata_se/anicCA_se
gruffly	kadakawA_se
grumpily	cidacidepana_se
guilelessly	niRkapatawApUrvaka
guiltily	aparAXI-BAva_se
gushingly	BAvukawApUrvaka
habitually	Axawana/Axawa_se
half-heartedly	bemana_se
half-hourly	AXe_GaNte_meM
half-price	AXA_mUlya/AXe_mUlya_para
half	aMSawaH
halfway	bIca_meM
haltingly	virAmawaH/savirAmawaH/ruka-ruka_kara/ladaKadAwe_hue
hand-over-fist	awiSIGra_va_BArI_rakama/SIGrawA_se_aXika_mAtrA_meM
handily	samIpa_se
handsomely	sunxarawA_se
handy	pAsa
haphazardly	UtapatAfga_se_/lAparavAhI_se/kramahInawaH/bewarawIbI_se/avyavasWiwawaH/akramawaH
happily	suKapUrvaka/KuSIpurvaka/saMyoga_se
hard-by	pAsa_meM/ke_pAsa
hard	xqDawA_se/pariSRamaSIlawA_si/pariSramaSIlawA_se/nITi/muSkila_se/mAwra/kaTorawA_se/kaTinawaH/kaTinAI_se/joda_se/kaTina
hardly	muSkila_se/SAyaxa_hI/kaxAciw_hI/alpawaH
harmlessly	hAni_ke_binA
harmoniously	saxBAvapUrNa_Dafga_se
harshly	kaTorawA_se
haste	jalxI
hastily	jalxI_se
hasty	SIGra/jalxabAjEYI_se/jalxabAjEYI_meM
haughtily	ahafkArapUrvaka/xamBapUrNa_Dafga_se
hauntingly	bAra_bAra_yAxa_Ane_se
hazily	sanxigXawaH/aspaRtawaH/aspaRta_rUpa_se/XuzXalApana_se
head-on	sIXe/sAmane_se/Amane-sAmane
head-to-head	sIXe
head	sAmane
headlong	badI_wejI_se/sira_ke_bala/anXAXunXa
healthily	Arogya_se
heartily	uwsAha_se/pUrI_waraha_se/bahuwa_aXika/KuSI-KuSI
heartlessly	nirxayawAse
heatedly	kroXapUrvaka/uwwejiwa_ho_kara
heavenward	svarga_kI_ora/AkASa_kI_ora
heavenwards	AkASa_kI_ora
heavily	BAra_sahiwa/bahuwa_aXika
hebdomadally	prawi_sapwAha
heedlessly	asAvaXAnI_se/XyAnahInawaH/lAparavAhI_se/asAvaXAnawaH
heftily	hraRta_puRtawAse/majabUwI_se
heinously	nqSaMsawA_se/jaGanyawApUrvaka
hellish	nArakIya
helpfully	maxaxa_karawe_hue
helplessly	lAcAra_se/asahAya_BAva_se
helter-skelter	hadabadI_meM/avyavasWiwa_Dafga_se
hence	isa_kAraNa_se/awaH/isalie
henceforth	Age_se/BaviRya_meM/isake_bAxa_se
henceforward	isake_bAxa_se
here	yahAz/iXara/isa_sWAna_para
hereabouts	AsapAsa_meM/AsapAsa
hereafter	BaviRya_meM/isakebAxa
hereby	isa_mAXyama_se/isake_xvArA
herein	isa_meM
hereof	isakA/se_sambanXiwa/isameM_se
hereto	ise/isa_bAwa_se/isako
heretofore	aba_waka/aBI_waka
herewith	isake_sAWa/ke_sAWa
hermetically	vAxya_praBAvoM_se_rakRiwa/vAyuruxXa_Dafga_se
heroically	sAhasa_ke_sAWa
hesitantly	hicakicAwA_huA
hideously	vikarAlawA_se
higgledy-piggledy	aswa-vyaswa_rUpa_se/aswa-vyaswa_Dafga_se
high	awyAXika/UzcAI_para
highly	awyaXika_UzcA/ucca/praSaMsApUrvaka/bahuwa_aXika
hilariously	prasannawA_se/hAsyapraxa_Dafga_se
hinderingly	prawiroXAwmaka_Dafga_se
hindermost	sabase_pICe_kA
hindmost	sabase_pICe_kA
historically	EwihAsika_rUpa_se
histrionically	nAtakIya_Dafga_se
hither	isa_waraPa/yahAz
hitherto	aba_waka/aBI_waka
hoarsely	rUKe_svarase/BarrAI_AvAja_se
holistically	sAkalyavAxI_Dafga_se
hollowly	xiKAvatI
home	GarelUpana/parivAra_meM
honestly	ImAnaxArI_se
honorably	prawiRTApUrNa_Dafga_se
honorific	sammAnapraxa
honourably	AxarapUrvaka/prawiRTApUrNa_Dafga_se/mAnapUrvaka
hopefully	ASA_se/Barose_se/ASApUrvaka
hopelessly	nirASA_se/nirASAjanaka_Dafga_se
horizontally	kREwija_sWiwi_meM/kRiwija_ke_samAnwara_xiSA_meM
horrendously	BayafkarawA_se/vikata_rUpa_se
horribly	Bayafkara_rUpase/burI_waraha_se
horrifically	romAFcakArI_Dafga_se/BayAvaha_Dafga_se
horrifyingly	BayavihvalawA_se/BayAvaha_Dafga_se
horseback	Gode_para_bETakara/Gode_kA_savAra
horticultural	uxyAnakqRi_xvArA
hospitably	Axara_sahiwa/AwiWeya_ke_sAWa
hotfoot	bahuwa_jalxI_meM
hotly	gusse_se/uwwejanApUrvaka
hourly	hara_GaNte_bAxa/eka_eka_GaNte_para
how	kEse/kiwanA/kisa_waraha/kEsA
however	waWApi/waba_BI/PiraBI/Pira_BI/jEse_BI
huffily	nArAjagI_se
hugely	bahuwAyawa_se/bahuwa_aXika
humanely	mAnavociwa_Dafga_se/mAnavIyawA_se
humanly	mAnavIyawOra_para
humbly	namrawApUrvaka
humiliatingly	apamAnajanaka_Dafga_se
humorlessly	parihAsa_rahiwa_Dafga_se
humorously	vinoxa_se/hAsyakara_Dafga_se
humourlessly	parihAsa_rahiwa_Dafga_se
hungrily	BUKase
hurtfully	cota_pahuzcAwe_hue
huskily	karkaSa_AvAja_se/BArI_AvAja_meM
hydraulically	jalaxAba_vyavasWA_ke_anusAra
hygienically	svAsWyakara_Dafga_se
hypocritically	pAKaNdapUrNa_Dafga_se
hypothetically	parikalpiwa_rUpa_se
hysterically	unmAxapUrNa_Dafga_se
idealistically	AxarSa_rUpa_meM/AxarSavAxI_Dafga_se
ideally	AxarSawaH
ideographically	BAvamUlaka_Dafga_se
ideologically	AxarSIkaraNawA_se/sExXAnwika_rUpa_se
idiomatically	muhAvarexAra_BARA_meM
idiotically	mUrKawApUrNa_Damga_se/mUrKawA_se
idly	lakRyahIna_rUpa_se/AlasyapUrvaka
idyllically	ramaNIya_Dafga_se
ignominiously	wiraskArapUrvaka/GqNiwa_Dafga_se
ignorantly	anaBijFawApUrvaka
ill	rUKAI_se/nirxayawA_se/muSkila_se/burI_waraha_se
illegally	avEXa_rUpa_se
illegibly	apaTanIya_Dafga_se
illogically	asafgawa_rUpa_se
imaginatively	kalpanAwmakawApUrvaka
immaculately	wrutihIna_Dafga_se
immediately	wawkAla/wuranwa_hI/usI_samaya/TIka/POrana/wuranwa
immensely	bahuwa_aXika
immesurably	viSAla_rUpa_se/apAra_rUpa_se
imminently	sannikatawApUrvaka
immoderately	bahuwa_aXika/amaryAxiwa_rUpa_se
immorally	anEwikawApUrvaka
immutably	aparivarwanIya_Dafga_se
impartially	niRpakRa_Dafga_se
impassively	BAvaSUnyawApUrvaka
impatiently	aXIrawa_se/aXIrawApUrvaka
impeachable	xoRa_lagAne_yogya
impenetrably	aBexya_rUpa_se
impenitently	binA_paCawAve_ke
imperceptibly	awisUkRma_rUpa_se/alakRiwa_rUpa_se
imperfectly	wrutipUrNa_Dafga_se
imperially	SAhI_Dafga_se
imperiously	xamBapUrNa_Dafga_se/sagarva/sABimAna/aBimAnapUrvaka
impersonally	nirapekRa_rUpa_se/avyakwigawa_rUpa_se
impertinently	XqRtawApUrvaka/DiTAI_se
imperturbably	avicaliwa_rUpa_se
impetuously	jalxabAjI_se
impishly	SarArawa_se
implacably	adiga_rUpa_se
implausibly	aviSvasanIya_Damga_se
implicitly	avyakwa_rUpa_se
imploringly	prArWanA_karawe_hue
impolitely	aSiRtApUrvaka
importantly	AvaSyaka_rUpa_meM/mahawwvapUrNa_Dafga_se
importunately	prArWanA_karawe_hue
impossibly	asamBAvya_rUpa_meM/asamBava_rUpa_se
impotently	napuMsakawA_se/asahAya_rUpa_se
imprecisely	asafkRipwa_rUpa_se/galawa_Dafga_se
impressively	praBAvapUrNa_Dafga_se/praBAvaSAlI_Dafga_se
improbably	asamBAvya_rUpa_se/aviSvasanIya_rUpa_se
impromptu	binA_wEyArI_ke
improperly	anuciwa_rUpa_se/anuciwa_Dafga_se
imprudently	asAvaXAnI_se
impudently	XqRtawApUrvaka/DiTAI_se
impulsively	AvegaSIla/AvegapUrNa_Dafga_se
in-situ	mUla_sWAna_para
in-toto	pUrNawa:
in	anxara/ina/in/BIwara/prawi/meM/kI_waraPa_se/ke_samaya_meM/ke_samaya/ke_anxara/se/kA/ke_anwargawa
inaccurately	aSuxXi_se/galawa_warIke_se
inadequately	ayogyawA_se/aparyApwa_rUpa_se
inadvertently	asAvaXAnI_se/galawI_se
inanely	nirarWakawA_se/mUrKawApUrNa_Dafga_se
inappropriately	anupayukwa_rUpa_se/anupayukwa_Dafga_se
inaptly	anuciwa_rUpa_se/akuSalawA_se
inarguably	avivAxAspaxa_rUpa_se
inarticulately	tUte-PUte_Dafga_se/sanxigXawaH/aspaRtawaH/aspaRta_Dafga_se
inattentively	beXyAnI_meM
inaudibly	XImI_Avaja_meM/sunAI_na_pade/Ese_Dafga_se
inauspiciously	aSuBa_Dafga_se
incalculably	beSumAra_warIke_se
incautiously	XyAnahInawaH/asAvaXAnIvaSa/asAvaXAnawaH
incessantly	lagAwAra
incestuously	kOtumbika_vyaBicAra_xvArA
inch	bAla_bAla
incidentally	akasmAwa/vEse/saMyoga_se/prasafgavaSa
incisively	wIkRNawA_se
including	sammiliwa_karawe_hue/sahiwa
inclusively	ko_milAwe_hue
incognito	ajFAwa_yA_gupwa_rUpa_se/ajFAwa_rUpa_se
incoherently	asmagawa_Dafga_se
incomparably	awulanIya_rUpa_meM/awulanIya_rUpa_se
incompetence	ayogyawA
incompetently	ayogyawApUrvaka
incompletely	apUrNawA_se
incomprehensibly	ajFAna/kaTinAI_se/aboXyawA
inconceivably	aciMwyanIyawA/kalpanAwIwa_Dafga_se
inconclusively	aniSciwi_se/binA_kisI_nirNaya_ke
incongruously	asafgawa_rUpa_se/atapate_Dafga_se
inconsequentially	binA_kisI_viSeRa_prasafga_ke
inconsiderably	mAmUlI_Dafga_se
inconsiderately	lA_paravAha_se
inconsistently	asWirawA_ke_sAwa
inconsolably	asAnwvanIya_rUpa_se
inconspicuously	aspaRtawA_se/aviSiRta_Dafga_se
incontestably	avivAxya_rUpa_meM/nirvivAxa_rUpa_se
inconveniently	asuviXAjanaka_Dafga_se
incorrectly	galawa_Dafga_se
incorrigibly	asuXArya_rUpa_se/aSAXya_Dafga_se
incorruptibly	BraRta_na_kie_jA_sakane_waka/saccariwrawA_se
increasingly	bahuwa_jyAxA/aXika_mAwrA_meM/uwwarowwara/lagAwAra/bahuwa_hI/baDawe_hue
incredibly	aviSvasanIya_rUpa_se/bahuwa_hI/AScaryajanka_rUpa_se
incredulously	aviSvAsapUrNa_Dafga_se
increduously	aviSvanIya_rUpa_se
incrementally	baDawa_ke_sAWa/vqxXi_ke_AXAra_para
incurably	asuXArya_rUpa_se/pakke_wOra_para/asAXya_rUpa_se
indecently	anuciwa_rUpa_se/Baxxe_Dafga_se/aSlIla_Dafga_se
indecisively	anirNAyakawA_se/aniScayAwmaka_Dafga_se/anirNAyaka_Dafga_se
indeed	vAswava_meM/vAkaI/sacamuca/niSciwa_hI/kya_sacamuca/avaSya_hI
indefatigably	aWaka_rUpa_se
indefinably	apariBARya_rUpa_se
indefinitely	aniSciwa_kAla_waka/aniyawa_rUpeNa
indelibly	sWAI_rUpeNa/amita_rUpa_se
independently	svawanwra_rUpa_se/svAXInawaH/alaga-alaga
indescribably	anirvacanIya_rUpa_se
indifferently	jEse_wEse/uxAsInawA_se
indignantly	kroXa_se/roRapUrvaka
indirectly	aprawyakRa_rUpa_se/parokRa_rUpa_se/aprawyakRawaH
indirvidually	eka_eka_karake/vyakwigawa_rUpa_se
indiscreetly	binA_vicAra_ke/avivekapUrNa_Dafga_se/binA_viveka_ke
indiscriminately	anXAXunXA/kramahInawaH/avyavasWiwawaH/anXAXunXa_warIke_se/akramawaH
indisputably	binA_vivAxa_ke/nirvivAxa_rUpa_se
indissolubly	aBexyawA_se/atUta_rUpa_se
indistinctly	aspaRtawA_se/sanxigXawaH/aspaRtawaH/aspaRta_rUpa_se
indivially	vyakwigawa_rUpa_se
individually	vyakwigawa_rUpa_se/eka-eka_kara_ke
indivisibly	aviBAjya_rUpa_meM/aviBAjya_rUpa_se
indomitably	axamya_rUpa_se
indoors	Gara_ke_BIwara/Gara_ke_anxara
inductively	vivecanAwmaka_rUpa_se
indulgently	anugrahapUrvaka/pakRapAwapUrNa_Dafga_se
industrially	Oxyogika_rUpa_se
industriously	mehanawa_se
ineffably	avarNanIya_rUpa_se
ineffectively	vqWA/niRpraBAvI_Dafga_se
ineffectually	asaPalawApUrvaka
inefficiently	ayogyawA_se/akRamawApUrvaka
inelegantly	asunxara_rUpeNa/apariRkqwa_Dafga_se
ineptly	ayogyawA_se/ayogyawApUrvaka
inescapably	na_talane_yogya/aparihArya_rUpa_se
inevitably	nissanxeha
inexcusably	akRamya_rUpa_se/akAraNa_hI
inexhaustibly	aviXvaMsiwA/aWaka_rUpa_se
inexorably	kaTorawA_se/anavarawa_rUpa_se
inexpensively	saswe_meM
inexpertly	anipuNawA_se/akuSala_Dafga_se
inexplicably	xurgamawA_se/binA_kisI_spaRtIkaraNa_ke
inexpressibly	avarNanIyawA_se/akaWanIya_rUpa_se
infectiously	safkrAmaka_rUpa_se
infernally	awyaXika
infinitely	bahuwa_jyAxA/bahuwa_haxa_waka
infinitesimally	awyamwa_sUkRma_mAwrA_meM
informally	anOpacArika_rUpa_se
infrequent	yaxA-kaxA
infrequently	kaBI-kaBAra
infuriatingly	kroXa_xilAwA_huA
ingeniously	pravINawApUrvaka
ingenuously	niRkapatawA_se
inherently	sahaja_rUpa_se
inhumanely	krUrawApUrvaka
inimitably	anoKe_Dafga_se/ananukaraNIya_Dafga_se
initially	SurU_meM
injudiciously	avivekapUrNa_Dafga_se
injurious	hAnikAraka_Dafga_se
inland	anxara
innately	svABAvika_rUpa_se/sahaja_rUpa_se
innocently	Bolepana_se/kAnUnI_Dafga_se
inontrouestibly	nirvivAxa_rUpa_se
inordinately	bahuwa_jyAxA
inquiringly	jijFAsApUrvaka
inquisitively	jijFAsApUrvaka
inquisitorially	jAzca-aXikArI_ke_anxAja_meM
insanely	pAgalapana_kI_haxa_waka
insatiably	awqpya_rUpa_se/asanwuRta_Dafga_se
inscrutably	rahasyamaya_Dafga_se
insecurely	asurakRiwa_rUpa_se/safkocaSIla_Dafga_se/asurkRiwa_rUpa_se
insensibly	behoSI_kI_hAlawa_meM
insensitively	asaMvexanaSIla_Dafga_se
inshore	kinAre_kI_waraPa
inside	mana_se/jela_meM/BIwara/anxara_se/anxara/meM/ke_anxara
insidiously	hAnikAraka/GAwaka_rUpa_se
insignificantly	nagaNya_rUpa_se
insincerely	JUTe_mana_se
insistently	haTapUrNa_Dafga_se
insolently	akKadapana_se
inspirationally	preraNAwmaka_Dafga_se
instantaneously	wawkRaNa/wawkAla_hI
instantly	SIGra/wuranwa
instead	ke_baxale_meM/usake_sWAna_para/baxala_meM/bajAya
instinctively	sahaja_rUpa_se/sahaja_boXa_se
instructively	SikRApraxa_rUpa_se
instrumentally	sahAyaka_ke_rUpa_meM
insufferably	asahya_rUpa_se
insufficiently	aparyApwa_rUpa_se
intangibly	sanxigXawaH/aspaRtawaH
intellectually	bOxXika_rUpa_se
intelligently	buxXimawwApUrvaka
intelligibly	samaJa_meM_Ane_lAyaka_Dafga_se
intensely	uwkatawA_se/wIvrawA_se
intensively	aXikawA_se/gahanawA_se
intentionally	jAna_bUJa_kara/jAnabUJA_kara
intently	uwsukawApUrvaka
inter-alia	anya_bAwoM_ke_sAWa
interactively	eka-xUsare_ko_praBAviwa_karawA_huA
interchangeably	vinimeyawA_ke_anusAra
interestingly	xilacaspI_se/maje_kI_bAwa_yaha_hE
interminably	ananwa_rUpa_se/anwahIna_Dafga_se
intermittently	AnwarAyikawA_se/ruka-ruka_kara
internally	Anwarika_rUpa_se/BIwarI_wOra_para
internationally	anwarrARtrIyawA_se/viSva_Bara_meM
interrogatively	jijFasApUrvaka
intimately	GaniRtawA_se/pariciwa_rUpa_se
into	anxara_ko/upara/meM/ke_anxara/guNiwa_karane_para
intolerably	asahyawA_se/asahya_rUpa_se
intransitively	akarmaka_rUpa_se
intravenously	anwarSirIya_viXi_se
intricately	jatilawApUrvaka
intriguingly	kuwUhalapUrNa_Dafge_se
intrinsically	wAwvika_rUpa_se
intuitively	sahaja_jFAna_se
invariably	sarvaxA/nirapavAxa_rUpa_se
inventively	AviRkAraSIla_Dafga_se
inversely	vyuwakramAnusAra/viparIwa_Dafga_se
invisibly	axqSya_rUpa_se
invitingly	luBAvane_Dafga_se
involuntarily	anicCA_se
inward	BIwara_kI_ora/apanI_ora
inwardly	mana-hI-mana/mana_mez
inwards	mana-hI-mana/BIwara_kI_ora/anxara_kI_ora
ironically	vyafgyapUrvaka/vyafgyapUrNa_Dafga_se/vidambanAwmaka_rUpa_se
irrationally	avivekapUrNa_Dafga_se
irrecoverably	saxA_ke_lie
irredeemably	burI_waraha_se
irregularly	aniyamiwa_rUpa_se/aniyamiwa_Dafga_se
irrelevantly	binA_kisI_prasafga_ke
irreparably	marammawa_na_kI_jA_sake{isa_waraha_se}
irresistibly	luBAvanA_se/prabala_rUpa_se/jabarxaswa_Dafga_se
irresolutely	xuviXA_meM
irrespective	kA_vicAra_kie_binA
irresponsibly	gEra_jimmexArAnA_Dafga_se
irreversibly	anuwkramaNIya_Dafga_se
irrevocably	aparivarwanIya_rUpa_se/atala_rUpa_se
irritably	cidacida_se/gussA_xilAne_kI_haxa_waka/cidacide_Dafga_se
irritatingly	KiJAne_vAle_Dafga_seA
jaggedly	teDe-meDe_Dafga_se
jauntily	prafullawApUrvaka
jealously	IrRyApUrvaka
jerkily	Jatake_ke_sAWa
jocosely	hazs-majAka_meM
jocularly	hazs-majAka_meM
jointly	mila_kara/saMyukwa_rUpa_se
jokingly	majAka_meM
jovially	prasannawApUrvaka
joyfully	KuSI_se
joyously	KuSI_se
jubilantly	prafulliwa_ho_kara
judiciously	vivekapUrNa_Dafga_se
jugful	jaga_Bara
just	yUzhI/wuranwa/TIka/SAyaxa/pUrNawaH/muSkila_se/mAwra/kevala/karIba-karIba/bilkula/aBI-aBI/vEsA_hI/aBI/isI_vakwa/uwanA_hI
justifiably	nyAyasafgawa_rUpa_se/samuciwa_kAraNoM_se
justly	ImAnaxArI_se
keenly	uwsukawA_se
keenness	uwsukawA
kindly	xayApUrvaka/kqpayA
knavishly	XUrwawApUrvaka
knee-deep	Gutane_waka
knowingly	jAnabUJakara/jAnabUJa_kara/jEse_rahasya_se_pariciwa_ho/is_waraha_se/jAna-bUJa_kara
laboriously	kaTinAI_se
laconically	safkRipwa_rUpa_se
lamely	aviSvasanIya_Dafga_se
lamentably	SocanIya_Dafga_se/burI_waraha_se
languidly	uwsAhahIna_warIke_se/SiWilawApUrvaka
languorously	AlasyapUrNa_Dafga_se
large	viswArapUrvaka/SeKI_mArawe_hue
largely	vyApaka_rUpa_se/purNawayA/muKya_rUpa_se
lasciviously	kAmukawApUrvaka
last	AKira_meM/sabase_bAxa_meM/anwima_bAra
late	xerI_se/xerawaka/xera_se/xera/bAxa_ke
lately	hAla_meM/hAla_hI_meM
later	bAxa_meM/bAxa/aXika_xera_waka/kuCa_samaya_paScAwa
laterally	pArSva_kI_ora/kI_waraPa_se
latter	anuvarwI
latterly	hAla_meM/Anwa_meM
laudably	sarAhanIya_rUpa_se
laughably	hAsyAspaxa_rUpa_se
laughingly	hazsI_hazsI_meM/majAka_meM/hazsawe_hue
lavishly	badI_mAwrA_meM/uxArawApUrvaka/Kule_hAWoM_se
lawfully	vEXa_rUpa_se
lazily	niruxyoga_raha_kara/AlasyapUrvaka
leasehold	patte_pera
leeward	havA_kI_xiSA_meM
left	bAyI_ora
leftward	vAmapanWa_kI_ora/bAzIM_waraPa/bAzIM_ora
leftwards	vAmapanWa_kI_ora/bAzIM_waraPa/bAzIM_ora
legally	kAnUnana
legato	aBamga_rIwi_se
legitimately	viXi-pUrvaka/kAnUnI_wOra_para
leisurely	iwmInAna_se/XIre-XIre
lengthways	lambAI_meM
lengthwise	lambAI_meM
leniently	naramI_se
lento	vilambiwa_meM
less	kama/WodA_sA/kama_mAqA_me
lethargically	suswa_Dafga_se
liberally	uxArawApUrvaka
licentiously	svcCanxawApUrvaka
light-heartedly	prasannawA_se
light	xIre-xIre/namrawA_se/halakepana_se/AsAnI_se
lightly	halke_se/upekRApUrvaka/halake_se/akAraNa/kama_meM/gamBIrawA_rahiwa_hokara
like	usI_DMaja_se/waraha_kA/jEsA
likely	samBavawaH/samBAvanA_ke_sAWa
likewise	vEse_hI/isI_waraha/wulanIya
limpidly	suspaRta_rUpa_se
limply	DIle-DAle_Dafga_se
linearly	rEKikawaH
lingeringly	xera_waka
linguistically	BARA-vijFAna_kI_xqRti_se/BARA_ke_AXAra_para
listlessly	niruwsAhI_Dafga_se
literally	yaWASabxa/vaswuwaH/pUrI_waraha_se/akRaraSa:/vaswuwa
lithely	locaxAra_Dafga_se
liturgically	pUjana_paxXawi_ke_anusAra
live	jI_jANa_se/Gatiwa_hone_vAlI
locally	sWAnIya_wOra_para/pAsa_meM
loftily	gOravaSAlI_Dafga_se
logistically	samBAra_wanwrAnusAra
long-distance	xUra_se
long-windedly	SabxAdambarapUrNawA_se
long	xUra_waka/lambe_samaya_waka
longer	aXika_samaya_ke_lie
longingly	lalaka_ke_sAWa
longitudinally	xeSAnwara_ke_anusAra/lambe_samaya_waka/lambAI_kI_waraPa_se
look	wiraskAra_se
loose	svawaH/AjAxI_se
lopsidedly	wiraCe_anxAja_meM
loud	Uzce_svara_se/jora_se
loudly	jEYora_se
low	mMaxa_svara_mem/nIce/XIre_se
loyally	vaPAxArI_se
lucidly	suboXagamya_rUpa_se
luckily	BAgya_se/sOBAgyavaSa
ludicrously	hAsyAspaxa_Dafga_se
lugubriously	viRAxapUrNa_Dafga_se
luminously	camakIle_Dafga_se
luridly	sanasanIKeja_Dafga_se
lustily	hqRta-puRta_Dafga_se
luxuriously	vEBavapUrvaka
lyrically	SabxoM_ke_hisAba_se/bAvAwmaka_rUpa_se
maddeningly	pAgala_kara_xene_vAle_Dafga_se
madly	gusse_se/pAgaloM_kI_waraha/bekAbU_Dafga_se
magically	jAxuI_Dafga_se
magnanimously	uxArawApUrvaka
magnetically	cumbakIya_Dafga_se/cumbaka_kI_waraha
magnificently	SAnaxAra_Dafga_se/Bavya_Dafga_se/awyaXika_sunxara_Dafga_se
mainly	pramuKa_rUpa_se/muKya_rUpa_se
majestically	SAnaxAra_Dafga_se
malevolently	xveRapUrNa_BAva_se
maliciously	xurBAvanApUrNa_Dafga_se
manfully	SUravIra_kI_waraha
manically	pAgala_kI_waraha
manifestly	sAPa_wOra_para
manually	haswacAlana_se
marvellously	AScaryajanaka_rUpa_se
marvelously	AScaryajanaka_rUpa_se
massively	viSAla_pEmAne_para
materially	mahawwvapUrNa_Dafga_se/ArWika_rUpa_se
maternally	mAwqsulaBa_Dafga_se
mathematically	gaNiwa_ke_anusAra
mattter-of-factly	vyAvahArika_warIke_se
maturely	paripakva_Dafga_se
may-be	samBavawaH
may	samBavawaH
maybe	SAyaxa/samBavawaH
meagerly	kiPAyawa_se
meagrely	kiPAyawa_se
meaningfully	arWapUrNa_rUpa_se/arWapUrNa_Dafga_se
meaninglessly	nirarWaka_rUpa_se
meanly	xarixrawApUrvaka/nIcawApUrvaka/kaTorawApUrvaka/kaFjUsI_se
meantime	isI_bIca/isa_bIca
meanwhile	isI_xOrAna/isa_bIca
measurably	paryApwa_mAwrA_meM
mechanically	yAnwrika_rUpa_se/yanwravaw_DAfga_se/maSIna_kI_sahAyawA_se
mechanistically	yanwravaw_Dafga_se
medically	cikiwsASAswra_ke_anusAra
meekly	cupacApa/xabbUpana_se
melodiously	surIle_Dafga_se
melodramatically	awinAtakIyawA_se/awinAtakIya_Dafga_se
memorably	yAxagAra_Dafga_se/avismaraNIya_Dafga_se
menacingly	darAvane_Dafga_se
mentally	mAnasika_rUpa_se
mercifully	xayApUrvaka/sOBAgya_se
mercilessly	nirxayawA_se/nirxayawApUrvaka/niRTurawApUrvaka
merely	mAwra
merrily	prasannawApUrvaka/beXyAnI_se
messily	ganxe_warIke_se
metaphorically	lAkRaNika_rUpa_se
methodically	kramabaxXa_Dafga_se
methodologically	suvyavasWiwa_Dafga_se
meticulously	sawarkawApUrvaka
microscopically	sUkRmaxarSI_xvArA/sUkRmawApUrvaka
middle	bIca_meM
middling	kAmacalAU_Dafga_se
midnight	AXI_rAwa
midway	bIca_meM/bIca
midweek	sapwAha_ke_maXya_meM
mightily	bahuwa_prayawnapUrvaka/bahuwa_aXika
mighty	bahuwa
mildly	namrawA_pUrvaka/WodA-bahuwa/namrawApUrvaka
militarily	sEnya_xqRti_se
mindfully	sAvaXAnI_se
mindlessly	binA_soce-vicAre
minimum	kama_se_kama
minus	ke_binA/GatA
minutely	bArIkI_se/sUkRmawA
miraculously	camawkArapUrNa_Dafga_se
mirthfully	ullAsa_ke_sAWa/KuSI_se
mirthlessly	prasannawArahiwa_Dafga_se
mischievously	SEwAnI_pUrNa/SarArawI_Dafga_se
miserably	xayanIya_Dafga_se
misguidedly	paWa_se_Batake_hue_Dafga_se
misleadingly	bahakAwe_hue/BrAmaka_rUpa_se
missing	KoyA_huA
mistakenly	BUla_se
mistily	aspaRta_rUpa_se
mistrustfully	aviSvAsa_ke_sAWa/aviSvAsapUrNa_Dafga_se
mockingly	upahAsapUrNa_Dafga_se
moderate	Osawa_xarje_kA
moderately	saMyama_ke_sAWa/sAmAnya_rUpa_se/kAmacalAU_Dafga_se/XIme
modestly	safkocaSIla_Dafga_se/safkoca_se
modishly	cuswa-xuruswa_Dafga_se
momentarily	Wodi_xera_ke_lie/Wodi_hI_xera_meM/pala_Bara_ke_lie
monochrome	eka_hI_rafga_kA
monotonously	nIrasa_Dafga_se
monstrously	Baxxe_Dafga_se
monumentally	bahuwa_aXika
moodily	uxAsI
moralitically	nIwivAxAwmaka_rUpa_se
morally	nEwika_rUpa_se
morbidly	rugNa_rUpa_se
mordantly	wIkRNawApUrvaka/katuwApUrvaka
more-over	isake_awirikwa
more	aXikawara/aXika_mAwrA_meM/awyaXika
moreover	isake_alAvA
morganatically	anuloma_vivAha_ke_xvArA
mornings	prawyeka_subaha/subaha_meM
moronically	bAliSawA_se
morosely	cidacide_Dafga_se
mortally	GAwaka_rUpa_se/BIRaNa_rUpa_se
most	sabase_aXika/lagaBaga/awyaXika
mostly	prAyaH/mUKya_rUpa_se/aXikAMSa
motionlessly	gawihInawA_se
mournfully	SokAkula_Dafga_se
movingly	hqxayasparSI_Dafga_se
much	bahuwa/prAyaH/Ora/karIba-karIba
multifariously	viviXa_prkAra_se
mundanely	sAXAraNa
munificensely	xayASIlawA_se
murderously	nirxayawA/hiMsra_Dafga_se
musically	safgIwa_suKAnwaka/surIle_Dafga_se/safgIwa_kOSala_ke_sAWa/safgIwa_ke_hisAba_se
mutely	KAmoSI_se/cupacApa/binA_bole
mutual	eka_jEsA
mutually	pArasparika_rUpa_se/paraspara
naively	bevakUPoM_kI_waraha
nakedly	Kule_rUpa_se/nirvaswra_rUpa_se/arakRiwa_Dafga_se
namely	jEse/yaWA/jEse_ki
narrowly	safkIrNawApUrvaka/jarA_sA/bArIkI_se/sakarAI_se
nastily	ciDa_kara
nationwide	xeSa_Bara_meM
nattily	cuswa-xuruswa_Dafga_se
naturally	svaBAvika_rUpa_se/prAkqwika_rUpa_se/beSaka/svaBAva_se
naughtily	SarArawapUrNa_Dafga_se
nauseatingly	GqNiwa_rUpa_se
nay	nahIM/balki
near	nikata/pAsa_se/pasa/nikata_se/najaxIka/lagaBaga/karIba-karIba/karIba/ke_pAsa/ke_najaxIka
nearby	pAsa_hI/pAsa_meM
nearly	karIba_karIba/wakarIbana/saba_kuca/prAyaH/milawA-julawA/lagaBaga/Kule_rUpa_se/GaniRTa_rUpa_se/GaniRta_rUpa_se/bArIki_se
neat	saPAI_se
neatly	svacCawApUrvaka/suvyavasWiwa_Dafga_se/saPAI_se
necessarily	anivArya_rUpa_se/AvaSyaka_rUpa_se
needlessly	anAvaSyaka_rUpa_se
negatively	qNAwmaka_rUpa_meM/nakArAwmaka_rUpa_meM/qNAwmaka_Dafga_se/galawa_warIke_se
negligently	beparavAhI_se/lAparavAhI_se
neither	na_hI/nahIM/na
nervously	GabarAwe_hue/uwwejiwa_AkulawA_sem/GabarAe_hue_anxAJEYa_meM
neurotically	vikRipwawApUrvaka
neutrally	watasWa_BAva_se/niRkriyawApUrvaka
never	kaBI_nahIM/kaBI_BI/jarA_BI_nahIM/bilkula_nahIM/[kaBI]_nahIM
nevermore	aba_se_nahI/Pira_kaBI_nahIM
nevertheless	waWApi/waba_BI/Pira_BI
newly	nayA_nayA/nayA
next-to	bagala_meM/ke_bAxa/lagaBaga
next	pAsa_meM/bAxa_meM/bagala_meM/usake_bAxa
nicely	acCe_se/sanwoRapraxa/acCI_waraha_se
nigh	lagaBaga/pAsa
night-long	rAwaBara
nightly	hara_rAwa
nights	rAwa_meM
nimbly	PurwI_se
no	nahIM
nobly	uxArawA_ke_sAWa
nohow	kisI_BI_waraha_se_nahIM/ekaxama_nahIM
noiselessly	binA_AvAja_kie
noisily	Sora-SarAbe_ke_sAWa
nominally	nAma_ke_lie
non-stop	avirAma/binA_ruke/lagAwAra
non	gEra
nonchalantly	niSciMwawApUrvaka/uxAsInawA_se
none-the-less	Pira_BI
none	bilkula_nahIM/bilkula_BI_nahIM
nonetheless	Pira_BI/waba_BI
nonsensically	arWahIna_Dafga_se
nope	nahIM
normally	sAmAnyawaH/sAmAnya_rupe_se/AsAnI_se/Ama_wOra_para/sAmAnyawa:
north-eastward	uwwara_pUrva_kI_ora
north-eastwards	uwwara_pUrva_kI_ora
north-west	uwwara_paScima_kI_ora
north-westward	uwwara_paScima_kI_ora
north-westwards	uwwara_paScima_kI_ora
north	uwwara_kI_Ora/uwwara_ki_aora/uwara_xeSa_kI_Ora
northward	uwwara_meM/uwwara_kI_ora
northwards	uwwara_meM
northwestwards	uwwarapaScimonmuKa
nosily	Sora_macAwe_hue
nostalgically	yAxa_meM_Awura_ho_kara
not	nahIM/na
notably	viSeRakara/viSeRawaH
noticeably	sAPa_sAPa/spaRta_rUpa_se
notionally	anumAnawaH
notoriously	viSeRa_rUpa_se/kuKyAwa_rUpa_se
notwithstanding	waba_BI/Pira_BI/waWApi/ke_bAvajUxa
now-and-then	kaBI_kaBI
now-or-never	aba_yA_kaBI_nahI
now	aba/wuranwa/waba/POrana/isa_samaya/ina_xinoM/Ajakala/aBI
nowadays	Ajakala
nowhere	kahIM_nahIM/suxUra/kisI_jagAha_nahIM
numbly	jadavawa_ho_kara
numerically	safKyAnusAra/safKyA_kI_xqRti_se
nutritionally	poRaNa_kI_xqRti_se
nuttily	pAgaloM_kI_waraha_se
o'clock	baje/samaya_bawAne_kelie
o	kA{_oYPa_kA_safkRipwIkaraNa}
obediently	AjFAkArI_Dafga_se
objectively	watasWa_BAva_se
obligingly	uxArawApUrvaka/anugrAhI_Dafga_se
obliquely	wiraCA/teDA
obliviously	anajAna_raha_kara
obnoxiously	aprIwikara_DaGa_se
obscenely	bahuwa_aXika/aSlIlawApUrvaka
obscurely	aprawyakRa_rUpa_se
obsequiously	cApalUsI_Bare_Dafga_se
observably	spaRta_rUpa_se
obsessionally	pAgaloM_kI_waraha_se
obsessively	pAgaloM_kI_waraha_se
obstinately	haTapUrvaka
obstructively	prawiroXAwmaka_Dafga_se
obtrusively	bAXaka_rUpa_se
obtusely	mUrKawApUrvaka
obviously	spaRta_rUpa_se/spaRtaH
occasionally	kaBIkaBI/kaBI-kaBI
oddly	ajIba_waraha_se/AScaryajanaka_rUpa_se
of	kA/se/ke_bAre_meM/meM_kA
off-stage	nepaWya_se
off	xUra/se_xUra_hatakara/se_xUra/se_alaga/se/para_se
offensively	apriya_Dafga_se/Apawwijanaka_Dafga_se/AkrAmaka_rUpa_se
offhand	wuranwa/rUKepana_se
offhandedly	wuranwa/rUKepana_se
officially	sarakArI_wOra_se/sarakArI_wOra_para/AXikArika_rUpa_se
officiously	xaswanxAjI_karawe_hue
oft	bahuXA/aksara/prAyaH
often	aksara/prAyaH/bAra/bahuXA
okay	vilkula_Tika/Tika
on-stage	maFca_para
on	lagAwAra/para/pe/ora/meM/ko/ke_upara/ke_pAsa/ke_kinAre/ke_bAre_meM
onboard	savAra
once-again	eka_bAra_Ora
once-and-for-all	AKarI_bAra
once	eka_bAra/kaBI_pahale/eka_bAra_jaba/pahale
only	kevala/waBI/sirPa/mAwra/mAtra/kiMwu/hI
onshore	wata_kI_ora/samuxra_kI_ora
onstage	maFca_para
onto	para/pICe_padanA
onward	Age
open-mouthed	muzha-bAe
openly	prakata_rUpa_se/KullamaKullA/Kule_wOra_para
opportunely	mOke_para
opposite	Amane-sAmane/ke_sAmane
oppressively	xamanAwmaka_Dafga_se/umasaxAra_Dafga_se
optically	xqRtigawa_rUpa_se
optimistically	ASAvAxI_Dafga_se
opulently	vEBavapUrNa_Dafga_se/AlISAna_Dafga_se
orally	mOKika_rUpa_se/muzha_se
orderly	suvyavasWiwa_rUpa_se
ordinarily	sAmAnya_rUpa_se/sAmAnyawayA
organically	safGatiwa_rUpa_se/kArbanika_rUpa_se/jEvika_rUpa_se
originally	Suru_Suru_meM/spaRtawaH/Axi_meM
ornately	alafkqwa_Dafga_se
ostensibly	prakata_rUpa_se
ostentatiously	BadakIle_Dafga_se
otherwise	anyaWA/xUsare_prakAra_se/nahIM_wo
out-of-the-way	sAmAnya_se_hata_kara
out	bAhara/xUra/jora-se/hadawAla_para/calA_gay/Kawama/anwa/behoSa/ke_bAhara
outdoors	Gara_ke_bAhara/Kule_mExAna_meM/bAhara
outlandishly	viciwra_Dafga_se/anoKe_Dafga_se
outrageously	KarAba_Dafga_se/awyXika
outright	wuranwa/sAPa-sAPa/pUrNawayA
outside	bAhara/bAhara_kI_ora/se_pare/se_bAhara/ke_bAhara
outspokenly	Kullama-KullA
outstandingly	ulleKanIya_rUpa_se/asAXAraNa_rUpa_se
outward	bAhara_kI_ora
outwardly	bAhyawaH/xeKane_meM/bAhara_se
outwards	bAhara_kI_ora
over-much	awyaXika
over	nIce_girA_huA/se_aXika/Bara/xUsarI_ora/waka/varRa_se_jyAxA/bacA_huA/Kawama/bArabAra/se_upara/para/meM/ke_upara_se/ke_upara/ke_samaya/ke_bAvajUxa/Upara/isa_ora_se_usa_ora_waka/suxUra/se_jyAxA/bIca/xaramiyAz/kaTinAiyAz_se_mukwa/prasAriwa/weja_AvAja
overall	kula_milAkara
overarm	bAzha_uTA_kara
overboard	nAva_para_se_pAnI_meM/jahAja_para_se_pAnI_meM/pAnI_meM_giranA
overground	jamIna_ke_Upara
overhand	bAzha_uTA_kara
overhead	Upara/sira_ke_Upara
overland	sWala_mArga_se
overleaf	pqRTa_ke_usa_waraPa
overly	bahuwa_jyAxA
overnight	rAwa_Bara/eka_rAwa_meM/sahasA
overpoweringly	jabarxaswa_Dafga_se
overseas	samuxra_pAra/samuxrapAra
overtime	aXika_samaya_waka/samayopari
overtly	KullamaKullA
overwhelmingly	jabarxaswa_Dafga_se
owing-to	hewu_se
owlishly	ullU_kI_waraha
pace	kI_anumawi_se
painfully	kaRtapUrvaka/aprIwikara_Dafga_se
painlessly	binA_kaRta_ke
painstakingly	kadI_mehanawa_se
palely	PIke_Dafga_se/kAnwihIna_Dafga_se
pallidly	PIke_Dafga_se
palpably	spaRta_rUpa_se
paradoxically	viroXABAsI_Dafga_se
parasitically	parajIvI_ke_samAna
parenthetically	nikRipwa_karawe_hue
parrot-fashion	lagAwAra_ratawe_hue
parsimoniously	kqpaNawApUrvaka/kaFjUsI_se
part	WodI
partially	AMSika_rUpa_se
particularly	viSeRa_rUpa_se/KAsa_wOra_para
partly	kuCa_kuCa/kuCa_haxa_waka/kuCa_aMSa_waka/AMSika_rUpa_se
passably	kAmacalAU_Dafga_se
passim	yawra-wawra
passionately	AveSa_meM_A_kara
passively	niRkriyawApUrvaka
past	pAsa_se_ho_kara/xvArA/se/ke_pare/ke_bAxa/ke_Age/pare/se_aXika
pat	wuranwa
patchily	kahIM-kahIM_para
patently	spaRtawaH
paternally	piwA_kI_waraha
pathetically	xayanIya_Dafga_se/kAruNika_Dafga_se/bahuwa_hI
pathologically	rogavijFAna_kI_xqRti_se
patiently	XEryapUrvaka
patronisingly	xamBapUrNa_xayA_ke_sAWa
patronizingly	xamBapUrNa_xayA_ke_sAWa
peaceably	SAnwipriyawA_se/SAnwipUrNa_Dafga_se
peacefully	SAnwi_se/SAnwipUrvaka
peculiarly	viSeRa_rUpa_se/ajIba_waraha_se
pedagogically	SEkRaNika_xqRti_se
pedantically	paNdiwAU_Dafga_se
peevishly	SikAyawI_Dafga_se/cidacide_Dafga_se
pejoratively	niMxAwmaka_Dafga_se
pell-mell	hadabadI_meM
penally	xaNdAwmaka_rUpa_se
pending	waka
pensively	vicAramagna_Dafga_se/viRaNNawA_se
peppily	sPUrwipUrvaka
per-capita	prawivyakwi
per-cent	prawi_sEkadoM_meM_eka_BAga
per-se	apane_Apa_meM
per	prawi
percent	prawiSawa
perceptibly	prawyakRarUpa_se/spaRta_rUpa_se
perceptively	kuSAgrabuxXi_se/anuBUwikRama_Dafga_se
perchance	kaxAciwa
peremptorily	alafGanIya_rUpa_se/nirNayAwmaka_Dafga_se
perennially	SASvawa_rUpa_se
perfectly	pUrNawaH/purNa_rUpa_se/acCI_waraha_se/acCe_warike_se/bilkula/pUrNa_rUpa_se
perforace	balapUrvaka
perfunctorily	yanwravaw_Dafga_se/lAparavAhI_se
perhaps	SAyaxa/samBavawa/ho_sakawA_hE/samBavawaH
periliously	safkatapUrNa_rUpa_se
perilously	safkatapUrNa_Dafga_se/KawaranAka_Dafga_se
period	yaha_waya_hE
periodic	niyawakAla_meM
periodically	samaya-samaya_para
peripherally	sawahI_wOra_para
permanently	sWAyI_rUpa_se
perpetually	niranwara/hameSA
perpexedly	vyAkulawA_se
perplexedly	hErAnI_se
persistently	xurAgrahapUrvaka/lagAwAra
personally	svayaM/vyakwigawa_rUpa_se/svaMya/Kuxa
perspicaciously	cawurAI_se/buxXikOSala_ke_sAWa
persuasively	prawyayakAriwApUrvaka
pertinently	prAsafgikawA_ke_sAWA
pertly	XqRtawApUrvaka/DiTAI_se
pervasively	vyApaka_rUpa_se
perversely	vikqwa_rUpa_se
pessimistically	nirASAvAxI_Dafga_se
pettishly	cidacidA_kara
petulantly	cidacidA_kara
philosophically	xArSanika_Dafga_se/xarSana_kI_xqRti_se
phonemic	svanima_kI_xqRta_se
phonetically	XvanyAwmaka_rU_pa_se
phoneticaly	svaraXvani_se
photographically	PotogrAPa_ke_mAXyama_se
phut	Pata
physically	SArIrika/saSarIrI/SArIrika_rUpa_se/prakqwi_ke_anusAra/prAkqwika_niyama_ke_anusAra
physiologically	SArIrika_xqRti_se
piano	XIme_se
pictorially	ciwroM_kI_sahAyawA_se/ciwrAwmaka_DaMAga_se
picturesquely	ciwramaya_rUpa_meM/sarasawA_se
piecemeal	WodA-WodA_karake/eka-eka_karake
piercingly	wIKI_AvAja_meM/awyaXika
piggyback	pITa_para
pigheadedly	jixxI_Dafga_se/adiyala_Dafga_se
piously	saxAcAriwApUrvaka
piping	KaxabaxAwA_huA/bahuwa_aXika
piquantly	masAloM_ke_sAWa/catapate_Dafga_se
pit-a-pat	Xaka-paka
pit-a-pit	XadaXadAwe_hue
pithily	sAragarBiwa_Dafga_se
pitiably	xayanIya_Dafga_se
pitifully	xayanIya_Dafga_se/kAruNika_Dafga_se
pitilessly	nirxayawApUrvaka
pitter-patter	XadaXadAwe_hue
pityingly	xayA_ke_sAWa
placidly	SAnwipUrvaka/SAnwa_Dafga_se
plain	vykwa_wOra_se/spaRtawaH/sapRta_wOra_se/sapRta_rUpa_se/sPaRtawayA
plainly	spaRta_rUpa_se/spaRtawaH/sAxagI_se/sAPa_wOra_para/sAPa-sAPa
plaintively	xuKI_ho_kara/xuKa_ke_sAWa/viRAxapUrNa_Dafga_se
plausibly	viSvasanIya_Dafga_se
playfully	prasannawA_se/majAkiyA_Dafga_se
pleadingly	nivexiwa_rUpa_se/prArWanA_karawe_hue
pleasantly	suKa_pUrvaka/suKaxa_rUpa_se/prafullawApUrvaka
pleasingly	suKaxa_rUpa_se
pleasurably	AnanxapUrvaka
plenteously	pracurawApUrvak
plentifully	bahuwa_jyAxA/pracurawApUrvak
plenty	bahuwa/aXika_mAwrA_meM
pliantly	lacIlepana_se
plum	ekaxama
plumb	ekaxama/TIka
plus	milAkara/Xana/Ora/isake_awirikwwa
poignantly	marmasparSI_Dafga_se/hqxayasparSI_Dafga_se
point-blank	sAPa-sAPa
pointedly	lakRya_karawe_hue/suspaRta_Dafga_se/sAragarBiwa_Dafga_se
pointlessly	nirarWakawApUrvaka
politely	SiRtawaH/SiRtAcArapUrvaka/SAlInawaH/saByawaH/namrawApUrvaka/bASaUra
politically	rAjanIwika_rUpa_se/vyavahAra-kuSalawA_kI_xqRti_se
pompously	Adambara_se/AdambarapUrNa_Dafga_se
ponderously	Baxxe_Dafga_se/nIrasa_Dafga_se/BArI-Barakama_Dafga_se
poorly	lastamapastama/asanwoRajanaka_Dafga_se
pop	jora_se_Pat
popularly	Ama_wOra_se/sAmAnyawayA/prajAwAnwrika_Dafga_se/janasAXAraNa_xvArA
portenously	KarAba_warIke_se
posh	uccavargIya_logoM_kI_waraha
positively	vAswavika_rUpa_se/sakArAwmaka_rUpa_se/niSciwa_rUpa_se
possessively	aXikAra_sahiwa/svawvaboXaka_Dafga_se
possibly	samBavawaH/yaWAsamBava/SAyaxa/kaxAPi/kaxAciw/samBava_ho_sakanA
post-free	dAka_BAra_mukwa_rUpa_meM
post-paid	xawwa-dAkaBAra_rUpa_meM
posthumously	maraNoparAnwa
potentially	samBavawaH/saSakwa_rUpa_se
potently	praBAvaSAlI_Dafga_se
powerfully	SakwiSAlI_Dafga_se/praBAvaSAlI_Dafga_se
practicably	vyAvahArika_Dafga_se
practically	vyAvahArika_xqRti_se/vyAvahArika_rUpa_se/vyAvahArika_rUpa_meM/vAswava_meM/lagaBaga
pragmatically	vyAvahArika_Dafga_se
pre-eminently	bahuwa_hI
precariously	sanxigXa_Dafga_se/KawaranAka_Dafga_se
precious	niwAnwa/awyanwa/asAXAraNawaH
precipitately	hadabadI_meM/hadabadA_kara
precipitously	sIXA/Kad
precisely	TIka/Tika-Tika/svaBAvavaSa/SuxXa_rUpa_se
precociously	akAlika_rUpa_se
predicatively	viXeyAwmaka_rUpa_se/viXeyAwmaka_Dafga_se
predictably	pUrvAnumeya_Dafga_se
predominantly	prabalawA_se/praXAna_rU_pa_se/muKyawaH
preferably	acCA_ho_ki
preferentially	aXimAnya_Dafga_se
prematurely	samaya_se_pUrva/asamaya_meM
prepositionally	pUrvasarga_kI_waraha/pUrvasarga_ke_wOra_para
preposterously	hAsyApaxa_rUpa_se/asafgawa_rUpa_se
present	samprawi/praswUwa_pralaKAnusara/Ajakala
presentably	praswuwa_karane_yogya_Dafga_se
presently	aBI_aBI/aBI/SIGra_hI/samprawi
presumably	samBavawaH/samBAvyawaH
presumptive	anumAniwa
pretentiously	AdambarapUrNa_Dafga_se
prettily	AkarRaka_Dafga_se/pyAre_Dafga_se
pretty	lagaBaga/kUba/KAsA/kAPI/awyaXika
previously	pahale
primarily	muKyawaH/muKya_rUpa_se
primly	OpacArika_Dafga_se/awinEwikawApUrNa_Dafga_se
primordially	pramuKa_rUpa_se/Axi_kAla_se
principally	muKya_rUpa_se
privately	vyakwigawa_rUpa_se
pro-term	wAwkAlika
proactively	agrasakriya_rUpa_se
probably	samBavawaH/SAyaxa
prodigally	KarcIle_Dafga_se
prodigiously	apUrvawAse/AScaryajanaka_rUpa_se/asAXAraNa_rUpa_se
productively	lABakArI_Dafga_se
professionally	xakRawApUrvaka/vyAvasAyika_wOra_para/vyAvasAyika_Dafga_se/peSevara_vyakwi_xvArA/vyavasAyika_Dfga_se
profitably	lABaxAyakawA_se/lABakArI_Dafga_se
profoundly	niwAnwa/pUrNawayA/pUrI_waraha_se/gaharAI_waka
profusely	bahulawA_se/pracurawApUrvaka/bahuwa_aXika_mAwrA_meM
progressively	uwwarowwara
prohibitively	bahuwa_aXika/niReXAwmaka_Dafga_se
prolifically	bahuPalaxAyakawA_se/bahusarjanAwmaka_Dafga_se/bahuprajananakArI_Dafga_se
prominently	praXAna_rUpa_se
promiscuously	svcCanxawApUrvaka
promisingly	ASAjanaka_Dafga_se
prompt	TIka
promptly	wuranwa/samaya_para/POrana/jalxI
pronto	wuranwa/POrana/jalxI
properly	TIka_se/uciwa_Dafga_se
prophetically	BaviRyavANI_karawe_hue/BaviRyavAN/BaviRyasUcaka_Dafga_se
propitiously	SuBa_Dafga_se
proportionally	anupAwa_meM
proportionately	anupAwa_meM
proprietorially	mAlikAnA_anxAja_meM
protectively	saMrakRAwmakawA_se/rakRAwmaka_Dafga_se
proud	gOravAnviwa/SAnaxAra
proudly	garva_se/SAnaxAra_Dafga_se/sagarva/sABimAna/aBimAnapUrvaka
proverbially	kuKyAwa_rUpa_se
provincially	prAnwa_xvArA
provisionally	asWAyI_rUpa_se
provocatively	ukasAwA_huA
provokingly	ukasAwA_huA
prudently	buxXimAnI_se/vivekapUrNa_Dafga_se/samaJaxArI_se
psychically	awIMxriya_rUpa_se
psychoanalyticallyly	manovESleRika_rUpa_se
psychologically	manovEjFAnika_warIke_se/manovijFAna_ke_AXAra_para/manovEjFAnika_xqRti_se
publicly	sArvajanika_rUpa_se/Kule_Ama
publicty	KuleAma
pugnaciously	JagadAlU_Dafga_se
punctiliously	viswArapUrvaka
punctually	Tika_samaya_para
pungently	wikwawApUrvaka/wIKepana_se
punitively	xaNdAwmaka_rUpa_se
punitorily	xaNdAwmaka_rUpa_se
purely	kevala/pUrNa_rUpa_se
purportedly	kaWiwa_rUpa_se
purposefully	uxxeSyapUrNa_Dafga_se/arWapUrNa_Dafga_se
purposely	jAnabUJakara/jAna-bUJa_kara
pursuant	ke_AXAra_para
pusillanimously	kAwarawApUrvaka
qua	kI_rUpa_meM/kI_hEsiyawa_se
qualitatively	guNAwmakawA_se/guNAwmaka_Dafgase
quantitatively	parimANAwmaka_Dafga_se/mAwrAwmaka
quarterly	viparIwa_xiSAoM_meM/prawi_wrimAsa/hara_cOWe_mahIne/wrEmAsika_kI_rIwi_se
queasily	becEnI_se
queerly	ajIba_waraha_se/sanxigXa_rUpa_se
querulously	SikAyawI_lahaje_meM/SikAyawI_Dafga_se
questionably	sanxigXa_rUpa_se
questioningly	praSna_pUrvaka/uwsukawApUrvaka/praSnAwmaka_Dafga_se
quick	wuranwa/SIGra/PurwI_se
quickly	PurwI_se/wuranwa/wejI_se/SIGrawA_se/sarasarI_wOra_para/Jatapata
quiet	SAnwi_se
quietly	XIre/SAnwipUrvaka/SAnwipUrNa_Dafga_se/niRkriya_Dafga_se/SAnwi_se
quiety	SAnwipUrvaka/cupacApa
quintessentially	sArawawva_rUpa_se/viSiRta_rUpa_se
quite	kAPI_haxa_waka/pUrNawayA/awyanwa/pUrI_wOra_se/sacamuca_hI/TIka_hE_!
quizzically	praSnAwmaka_Dafga_se/muskurAwe_hue{praSnasahiwa}
quote	eka_waraha_se
racially	jAwIyawA_kI_xqRti_se/jAwIyawA_ke_AXAra_para
radially	arIya_Dafga_se
radiantly	praPulliwa_Dafga_se
radically	mOlika_rUpa_se/mUlawaH
raffishly	XyAnahInawaH/lAparavAhI_se/asAvaXAnawaH
raggedly	ulte-sIXe_Dafga_se/teDe-meDe_Dafga_se/aniyamiwa_rUpa_se
rakishly	XyAnahInawaH/lAparavAhI_se/asAvaXAnawaH
rampantly	aniyanwriwa_rUpa_se
randomly	atakala-paccU_se/kramahInawaH/avyavasWiwawaH/anXAXunXa_warIke_se/akramawaH
rapidly	SIGrawA_se/wejI_se
rapturously	harRonmawwawA_ke_sAWa
rarely	kaxAciwa/kaBI_kaBAra
rashly	uwAvalepana_se/avivekapUrNa_Dafga_se
rather-than	isake_bajAya
rather	balki/yaWecCa/ulte/niHsanxeha/kuCa_haxa_waka/kuCa/apekRAkqwa
rationally	warkasafgawa_Dafga_se
rattling	bahuwa
raucously	ugrawApUrvaka/karkaSawApUrvaka
raving	ekaxama
ravishingly	sammohaka_Dafga_se/AkarRaka_Dafga_se
re	ke_viRaya_meM
readily	saralawA_se/niHsafkoca
ready	pahale_se_hI
real	bahuwa_hI/yaWArWa_meM
realistically	yaWArWavAxiwA_se/vAswava_meM/sacamuca_kA
really	vAswava_meM/vaswuwaH/sacamuca/yaWArWa_mez/AScarya_prakata_karanA
rearmost	sabase_pICe_kA
rearwards	pICe_kI_ora
reasonably	samuciwa_rUpa_se/paryApwa_mAtrA_meM/kAmacalAU_Dafga_se/viveka_ke_sAWa/samaJaxArI_se/kAPI
reassuringly	ASvaswa_karawe_hue
rebelliously	vixrohAwmaka_Dafga_se/akKada_Dafga_se
recently	hAla_mez/hAla_hI_meM/aBI-aBI
reciprocally	viparIwa_Dafga_se/pArasparika_rUpa_se/baxale_meM
recklessly	lAparavAhI_se/binA_vicAre
recognisably	pahacAne_jAne_kI_haxa_waka
recognizably	pahacAne_jAne_kI_haxa_waka
recurrently	bAra-bAra
redundantly	anAvaSyaka_rUpa_se
reflectively	vicAramagna_Dafga_se
refreshfully	wAjagI_xene_vAle_Dafga_se/sPUrwixAyaka_Dafga_se
refreshingly	wAjagI_xene_vAle_Dafga_se/sPUrwixAyaka_Dafga_se/AScaryajanaka_Dafga_se
regarding	ke_bAre_meM
regardless	XyAna_xie_binA
regrettably	SocanIya_Dafga_se/Kexajanaka_Dafga_se
regularly	niyamiwa_rUpa_se
relatively	wulanAwmaka_rUpa_se/pUrNawayA/apekRAkqwa
relentlessly	niRTura_Dafga_se/lagAwAra
relevantly	prAsafgika_rUpa_se
reliably	viSvasanIya_Dafga_se
religiously	niyamiwa_rUpa_se/niRTApUrvaka/ImAnaxArI_se
reluctantly	anicCA_se/anicCApUrvaka
remarkably	ulleKanIyawA_se/AScaryajanaka_Dafga_se
remorsefully	paScAwwApapUrvaka
remorselessly	nirxayawApUrvaka
remotely	xUra_ke/xUrI_para/xUra_se/WodA/suxUra
rent-free	kirAyA-mukwa
repeatedly	bAra-bAra/kaI_bAra/bArambAra
repetitiously	bAra-bAra
repetitively	xoharA_kara/bAra-bAra
reportedly	sunawe_hEM/KabaroM_ke_anusAra
repressively	xamanakArI_Dafga_se
reproachfully	ulAhane_Bare_anxAja_meM/AlocanAwmaka_Dafga_se
reprovingly	ulAhane_Bare_anxAja_meM/niMxAwmakawA_se/AlocanAwmaka_Dafga_se
reputedly	saba_logoM_kI_rAya_meM
resentfully	nArAjagIpUrvaka/aprasannawApUrvaka
resignedly	sabra_kara_ke/nirASApUrNa_Dafga_se
resiliently	samuwWAnaSakwisampanna_Dafga_se/prawiroXakRammawApUrNa_Dafga_se
resonantly	saMspanxiwa_Dafga_se
resoundingly	jabarxaswa_Dafga_se/burI_waraha_se
resourcefully	cawurAI_se
respectably	sammAnanIya_Dafga_se/SAlInawApUrvaka/paryApwa_rUpa_se
respectfully	sAxara/sawkArapUrvaka/sasammAna/AxarapUrvaka
respecting	ke_bAre_meM
respectively	kramaSaH/krama_se
resplendently	awyaXika_manamohaka_Dafga_se
responsibily	jimmexArI_se
responsibly	jimmexArI_ke_sAWa/viSvasanIya_Dafga_se
responsively	prawikriyAwmaka_Dafga_se
restlessly	becEnI_se
retail	Putakara
retroactively	pUrva_kriyAkalApa_ke_anusara
retrospectively	awIwalakRI_Dafga_se
revealingly	Kula_kara
revengefully	prawiSoXa_kI_BAvanA_se
reverentially	ShraxXApUrNa_Dafga_se
reverently	Axara_se/ShraxXApUrNa_Dafga_se
revoltingly	GinOne_Dafga_se
rhythmically	layabaxXa_Dafga_se
richly	bahuwAyawa_se/XanADyawApUrvaka/pUrNa_rUpa_se/pracura_mAwrA_meM
ridiculously	hAsyApaxa_Dafga_se/bewuke_Dafga_se
right-handed	XAyeM_hAWa_se
right	wuranwa/uciwa_rUpa_se/TIka_waraha_se/sIXe/pUrI_waraha_se/ImAnaxArI_se/TIka
righteously	nyAyasafgawa_rUpa_se
rightfully	nyAyapUrvaka/iMsAPa_se/jAyaja_wOra_para
rightly	uciwa_rUpa_se
rightward	xAhinI_ora
rightwards	xAhinI_ora
rigidly	saKwI_se/kaTorawApUrvaka/kadepana_ke_sAWa
rigorously	saKwI_ke_sAWa
riotously	upaxravI_Dafga_se/samqxXa_Dafga_se_kiyA_gayA
ritually	rivAja_ke_anusAra
roaring	burI_waraha_se
robustly	saKwI_se/majabUwa_Dafga_se
romantically	rUmAnI_Dafga_se
rottenly	bekAra_Dafga_se
rough	ugrawApUrvaka/aSiRtawApUrvaka
roughly	lagaBaga/ruKAI_se/bexarxI_se/asAvaXAnI_se/aSiRtawA_se
round	GumAva-PirAvake_sAWa/cAro_Ora/Bara
roundly	sAPa-sAPa/jabarxaswa_warIke_se
routinely	niyamiwa_rUpa_se/sAmAnyawayA/niyamawaH
rowdily	ugrawApUrvaka
royally	SAnaxAra_Dafga_se/SAhI_Dafga_se/rAjakIya_Dafga_se
rudely	aSiRta_vyavahAra/SiRtAcArahInawaH/ruKAI_se/aSiRtawaH/aSiRtApUrvaka/asaByawaH
ruefully	aPasosa_ke_sAWa/paScAwwApapUrvaka/KexapUrvaka
ruggedly	SiRtAcArahInawaH/majabUwa_Ora_AkarRaka_Dafga_se/aSiRtawaH/asaByawaH
ruinously	anarWakArI_Dafga_se
ruminatively	XyAnamagna_Dafga_se/vicAramagna_Dafga_se
ruthlessly	nirxayawApUrvaka
sadistically	parapIdA_ke_sAWa/nirxayawApUrvaka
sadly	xurBAgyavaSa/uxAsI_se/burI_waraha_se/xurBAgyavaSa_se
safely	salAmawI_se/surakRiwa_rUpa_se/niSSafka_ho_kara/nirApaxa_rUpa_se/galawI_kI_ASafkA_ke_binA/binA_kisI_nukasAna_ke/ArAma_se/kuSalapUrvaka/niSciwa_rUpa_se
sagaciously	samaJaxArI_se
sagely	samaJaxArI_se/buxXimawwApUrvaka
saintly	sanwasulaBa
same	usI_prakAra_se/samarUpa
sanctimoniously	DoMga_racawe_hue/xiKAvatI_nEwikawA_ke_sAWa
sapiently	sUJa-bUJa_ke_sAWa/samaJaxArI_se
sarcastically	vyafgyAwmaka_Dafga_se
sardonically	uphAsapUrNa_Dafga_se
sartorially	vaswroM_ke_mAmale_meM
satirically	vyafgyAwmaka_Dafga_se/vyafgyapUrNa_Dafga_se
satisfactorily	sanwoRajanaka_Dafga_se
satisfyingly	sanwoRajanaka_Dafga_se
saucily	XqRtawApUrvaka/DiTAI_se
savagely	jafgalIpana_se/SiRtAcArahInawaH/krUrawApUrvaka/jafgalI_jAnavara_kI_waraha/aSiRtawaH/asaByawaH
scalding	bahuwa_jyAxA
scandalously	Sarmanaka_Dafga_se
scantily	aparyApwa_rUpa_se
scarce	muSkila_se
scarcely	muSakila_se/SAyaxa_hI/muSkila_se/kevala/aBI-aBI
scathingly	katuwApUrvaka/kaTorawApUrvaka/awyanwa_katu_Dafga_se
sceptically	saMSayapUrNa_Dafga_se
schematically	yojanAbaxXa_Dafga_se
scientifically	vEjFAnika_xqRti_se
scornfully	avajFApUrvaka
scot-free	sahI-salAmawa
screamingly	haxa_se_jyAxA
scruffily	ganxe_Dafga_se
scrupulously	niRTApUrvaka/ImAnaxArI_se
scurrilously	apamAnajanaka_Dafga_se/aBaxra_Dafga_se
searchingly	KojI_Dafga_se
searingly	awyaXika
seasonally	mOsama_ke_anusAra
seasoned	anuBavI
seaward	samuxra_kI_ora
seawards	samuxra_kI_ora
second-class	xvIwIya_SreNI_meM
second-hand	xUsare_ke_mAraPawa/purAnA
second	xUsarA
secondarily	gONa_rUpa_se
secondly	xUsare/xUsarA
secretively	Cipakara/gupwa_rUpa_se
secretly	gupwa_rUpa_se/mana-hI-mana/gupwawaH
securely	surakRiwa_rUpa_se
sedately	saMyawa_Dafga_se
seductively	luBAwe_hue/kAmowwejaka_Dafga_se
sedulously	pariSramapUrvaka
seemingly	prawIyamAnawaH/prakatawaH/prakata_rUpa_se
seldom	SAyaxa_hI_kaBI/birale_hI/kaBI_kaBAra/kaBI-kaBAra
selectively	varaNakRamawApUrvaka
self-consciously	safkoca_se/AwmacewanA_se
self-destructively	AwmaGAwaka_rUpa_se
self-drive	apanI_kAra_lekara
self-righteously	xamBa_se
selfishly	svArWI_Dafga_se
selflessly	nisvArWa_BAva_se
semantically	arWa_kI_xqRti_se
semaphorically	semAPora_safkewa-paxXawi_ke_xvArA
sensationally	SAnaxAra_Dafga_se/sanasanIKeja_Dafga_se
senselessly	nirarWaka_Dafga_se/akAraNa_hI
sensibly	samaJaxArI_se
sensitively	saMvexanaSIla_Dafga_se
sensually	kAmuka_Dafga_se
sententiously	vAkyagawa/sAragarBiwa_Dafga_se
sentimentally	BAvukawApUrNa_Dafga_se
separate	alaga-alaga_se
separately	alaga-alaga/svawanwra_rUpa_se/alaga
sequentially	kramika_rUpa_se/yaWAkrama/kramAnusAra
serenely	SAnwa_BAva_se
serially	kramaSaH/kramika_Dafga_se
serious	gamBIrawA_se
seriously	gamBIra_rUpa_se/gamBIrawA_se
servilely	cApalUsI_Bare_Dafga_se
sevenfold	sAwa_gunA_aXika/sAwa_gun
severally	alaga-alaga/kramaSaH
severe	kaTorawA_se
severely	kaTorawA_se/sAxe_Dafga_se/gamBIra_rUpa_se
sexily	kAmowwejaka_Dafga_se
sexually	lEMgika_rUpa_se
shabbily	PatIcara_Dafga_se/kRuxra_Dafga_se
shallowly	uWale_Dafga_se/uWalApana_se{sAzsa_lenA}
shamefacedly	lajjiwa_ho_kara
shapelessly	Baxxe_Dafga_se
sharp	XyAna_se/wIvrawA_se/wejI_se/TIka-TIka/sahasA
sharpish	PurwI_se
sharply	wIkRNawA_se/wejI_se/katuwApUrvaka
shatteringly	awyaXika
sheepishly	lajjiwa_Dafga_se
sheer	ekaxama
shiftily	XUrwawApUrvaka
shockingly	uxvegakArI_Dafga_se
shoddily	galawa_Dafga_se/bekAra_Dafga_se
shoot	wejI_se
short	ruKAI_se/ekAeka/acAnaka_hI/acAnaka
shortly	avilamba/SIGra/ruKAI_se/kuCa_samaya
showily	BadakIle_Dafga_se
shrewdly	smaJaxArI_se
shrilly	wIKI_AvAja_meM
shyly	SarmAwA_huA
sic	evameva
sickeningly	GqNA_uwpanna_karawe_hue/GinOne_Dafga_se
side-on	bagala_se
side-saddle	janAnA_jIna/janAnA_jIna_para
sidelong	wiraCI_najara_se
sideways	wIraCA_hokara/kI_waraPa/ki_aora_se/eka_waraPa_se
significantly	arWapUrNawA_se/ulleKanIya_Dafga_se/sAragarBiwa_Dafga_se/mahawwvapUrNa_Dafga_se/arWapUrNa_Dafga_se
silently	cupacApa/KAmoSI_se/binA_AvAja_kie
silkily	reSama_kI_waraha/mulAyama_warIke_se
similarly	usI_waraha_se/eka_jEse/isI_prakAra
simperingly	kAwarawApUrvaka
simplistically	awisaralIkqwa_Dafga_se
simply	sAxagI_se/pUrI_waraha_se/kevala/AsAnI_se
simultaneously	eka_sAWa
since	waba_se/se/uparAnwa
sincerely	sacamuca/ImanaxArI_se/BavaxIya
sinfully	pApamaya_AcaraNa_se
single-handed	akele
single-handedly	akele
single-mindedly	ekaniRTawA_se
singly	akele_hI/eka-eka_karake/alaga-alaga/ekaSaH
singularly	viSiRta_rUpa_se/ekaxama_hI/anaya_rUpa_se
sinlessly	pAparahiwa_AcaraNa_se
sinuously	lahariyAxAra_Dafga_se/GumAvaxAra_Dafga_se
sixfold	CaH_gunA
skeptically	saMSayapUrNa_Dafga_se
sketchily	sawahI_Dafga_se/nAma_ke_lie
skew-whiff	wiraCA
skilfully	kuSalawApUrvaka
skillfully	kuSalawApUrvaka
skittishly	GabarAe_hue_DafGa_se
skulfully	nipuNawA_se
sky-high	bahuwa_UzcA/bahuwa_Upara_waka/gaganacumbI
skyward	AkASa_kI_ora
skywards	AkASa_kI_ora
slam-bang	lAparavAhI_se
slap	TIka/sIXe
slapdash	anXAXunXa/lAparavAhI_se
slavishly	jyoM_kA_wyoM
sleekly	cikanA_karake
sleepily	unIMxA_hokara/unIMxe_Dafga_se
sleeplessly	binA_nIMxa_ke
slenderly	sImiwa_rUpa_se
slickly	cikane_kAgaja_oara
slightly	WodA_sA/xubale_Dafga_se/kuCa_haxa_waka
slimly	xubale_Dafga_se
sloppily	lAparavAhI_se
slow	XIre-XIre/XIre_se
slowly	XIre_se/XIre-XIre/vilambiwa_meM/SanEH_SanEH/AhiswA/XIre_XIre
sluggishly	XIre-XIre
slyly	XUrwawApUrvaka
smack-dab	TIka
smack	TIka/sIXe
small	mAmUlI_Dafga_se
smartly	suvyavasWiwa_Dafga_se/sAPa-suWare_Dafga_se/joSIle_Dafga_se/hoSiyArI_se/cuswa-xuruswa_Dafga_se
smooth	ArAma_se
smoothly	AsAnI_se/SiRtawaH/SAlInawaH/saByawaH/cikane_Dafga_se/binA_kisI_samasyA_ke/bASaUra/abAXa_gawi_se
smugly	AwmawuRta_Dafga_se
smuttily	aSlIlawApUrvaka/aSlIla_Dafga_se
snappily	rocaka_Dafga_se/cuswa_Dafga_se/cidacide_Dafga_se
snazzily	awyAXunika_Ora_AkarRaka_Dafga_se
sneakily	najara_bacA_kara
sneeringly	vyafgyAwmaka_Dafga_se
snidely	vyafgyAwmaka_Dafga_se
snugly	paryApwa/surakRiwa_Dafga_se/cuswa_Dafga_se/bade_ArAmaxeha_Dafga_se/acCA_KAsA
so-so	jEse-wEse/TIka-TAka/kAmacalAU_Dafga_se/bahuwa_sAXAraNa
so	wAki/vAswava_meM/usi_prakAra_kA/jEsA/iwanA/isi_lie/isalie/Ese/EsA/bahuwa_aXika/awyaXika/usI_waraha/samAna_rUpa_se/BI
soberly	sAxe_Dafga_se/gamBIra_BAva_se
socially	sAmAjika_rUpa_se/samAja_xvArA
sociologically	samAjaSAswrIya_Dafga_se
softly	komalawA_se/XIre/xabe_pAzva/sAxe_Dafga_se/mqxulawA_se
solely	pUrI_waraha_se
solicitously	vyagrawApUrvaka/ciMwiwa_ho_kara
solidly	majabUwI_se/lagAwAra/ekawA_ke_sAWa/binA_ruke
solo	akele
somberly	gamBIrawA_se
sombrely	gamBIrawA_se
some	pUrNawayA/lagaBaga/koI
someday	eka_xina/kaBI_BaviRya_meM
somehow	pawA_nahIM_kyoM/kisI_waraha_se/kisI_kAraNa_se/jEse-wEse/kisI_BI_waraha/vaha_kAraNa_jo_pawA_na_ho
someplace	kisI_jagaha/kahIM
sometime	kuCa_samaya
sometimes	kaBI_kaBI/Wode_samaya_se/kaBI-kaBI/kaBI_BI
someway	kisI_prakAra_se/kisI_waraha_se/kisI_kAraNa_se/jEse-wEse
someways	kisI_waraha_se
somewhat	kuCa/WodA-bahuwa/kuCa-kuCa
somewhere	kahIM/kisI_sWAna_meM/kisI_jagaha/kahIM_BI/kahiM
sonorously	guFjAyamAna_dafga_se
soon	SIGra/wuranwa/wadake/saralawA_se/POrana/nikata_BaviRya_meM/Jatake_se/jalxI_se/jalxI_hI/jalxI/jalxi
sooner	aXika_SIGra
soothingly	sAnwvanAxAyaka_Dafga_se
sorely	gamBIra_rUpa_se/kaRtapUrvaka/bahuwa_jyAxA
sorrowfully	xuKa_ke_sAWa
sotto-voice	XIme_svara_meM
soulfully	BAvapUrNa_Dafga_se
sound	gaharAI_ke_sAWa/acCI_waraha
sounding	jisakI_eka_KAsa_Xvani_ho
soundlessly	binA_AvAja_kie
soundly	acCI_waraha/pakke_Dafga_se/majabUwa_Dafga_se/kAPI_acCe_se/gaharI_nIMxa_meM/burI_waraha_se
sourly	katuwApUrvaka
south-eastward	xakRiNa_pUrva_kI_ora
south-westward	xakRiNa_kI_ora
south-westwards	xakRiNa_kI_ora
south	xakRiNa_kI_ora
southeast	xakRiNa_pUrva_kI_ora
southward	xakRiNa_kI_ora
southwards	xakRiNa_kI_ora
southwest	xakRiNa_paScima_meM/xakRiNa-paScima_kI_ora/xakRiNa_paScima_kI_ora
southwestward	xakRiNa_paScima_kI_ora
southwestwards	xakRiNa_paScima_kI_ora
spaciously	viswAra_ke_sAWa
sparingly	kiPAyawa_se
spasmodically	EMTana_ke_sAWa/bIca-bIca_meM/aniyamiwa_rUpa_se
spatially	sWAna_kI_xqRti_se
specially	KAsa_wOra_para/viSeRa_rUpa_se
specifically	viSeRa_rUpa_se/KAsa_wOra_para
spectacularly	asAXAraNa_rUpa_se/AlISAna_Dafga_se
speechlessly	KAmoSI_se/binA_bole
speedily	wejI_se/jalxI
spicily	masAloM_ke_sAWa/catapate_Dafga_se
spiritedly	joSapUrNa_Dafga_se/bahAxurI_se
spiritually	AXyAwmika_rUpa_se/aXyAwma_kI_xqRti_se
spitefully	xurBAvanApUrvaka/IrRyApUrvaka
splendidly	SAnaxAra_Dafga_se/Bavya_Dafga_se
spontaneously	ucCAnurUpa/svABAvika_rUpa_se/binA_pUrva_wEyArI_ke/apane-Apa
sporadically	Citaputa_rUpa_se/bIca-bIca_meM
sportingly	Kela_BavanA_ke_sAWa
sportively	Kela_Karala_meM
spotlessely	kalafka_rahiwa
spotlessly	sAPa-suWare_Dafga_se
sprucely	AkarRaka_Dafga_se
spuriously	JUTa-MUTa
square	sIXe
squarely	uciwa_rUpa_se
squeamishly	awisaMvexanaSIlawA_ke_sAWa
staccato	asambaxXa_rIwi_se
stage-left	maFca_kI_bAyI_ora
staggeringly	awyaXika
stanchly	niRTApUrvaka/kattarawApUrvaka
stark	bilkula
starkly	viroXABAsa_ke_sAWa/spaRta_rUpa_se/kaTorawApUrvaka
startlingly	AScaryajanaka_rUpa_se
statistically	sAfKyikI_ke_AXAra_para/AzkadoM_kI_xqRti_se
statutorily	saMvEXAnika_rUpa_se
staunchly	xqDawA_se/niRTApUrvaka/kattarawApUrvaka
steadfastly	xqDawApUrvaka
steadily	sWirawApUrvaka/niranwara
stealthily	Cipa_kara
steeply	wejI_se/sIXI_caDAI_meM/gaharAI_se
step-by-step	kramaSaH
sternly	kaTorawApUrvaka
stickily	cipacipe_Dafga_se
stiff	behaxa/awyAXika
stiffly	ruKAI_se/kadepana_ke_sAWa
stiflingly	xamaGoMtU_Dafga_se
still	waba_BI/Pira_BI/Ora_BI/aXika/aBI_BI/waWApi/jyAxA/wo_BI
stinking	bahuwa_jyAxA
stock-Still	sWira
stock-still	binA_hile-dule
stockily	gaTile_Dafga_se
stoically	nirlipwa_BAva_se/BAvanAhIna_Dafga_se
stolidly	BAvahIna_Dafga_se
stonily	kaTorawAse/BAvaSUnyawA_ke_sAWa
stormily	wUPAna_kI_waraha
stoutly	xqDawApUrvaka/majabUwI_ke_sAWa/hqRta-puRta_Dafga_se
stragglingly	aniyamiwa_rUpa_se
straight	sIXA/TIka_se/sIXe/sAPa_wOra_para/lagAwAra
straightaway	wuranwa
straightforwardly	sIXI_waraha_se/ImAnaxArI_se
straightway	wuranwa/sIXA
strangely	ajIba_waraha_se/asAXAraNa_rUpa_se
strategically	yukwipUrvaka/upAyawaH/sAmarika_xqRti_se/kUtanIwika_xqRti_se
strenuously	xqDawA_se/saKwI_se
strictly	xqDawA_se/sirPa/saKwI_se/pUrI_waraha_se/kadAI_se/anuSAsanapUrvaka/kevala
stridently	karkaSawApUrvaka
strikingly	AScaryajanaka_Dafga_se/asAXAraNa_rUpa_se
stringently	kiPAyawa_se
strongly	SakwiSAlI_Dafga_se/praBAvaSAlI_Dafga_se/kAPI/kadAI_se
structurally	saMracanAwmaka_xqRti_se
stubbornly	jixa_meM_A_kara/haTaXarmiwApUrvaka/adiyala_Dafga_se
studiously	XyAna_se/jAna-bUJa_kara
stunningly	asAXAraNa_rUpa_se
stupendously	AScaryajanaka_rUpa_se
stupidly	mUrKawA_se
sturdily	prabala_rUpa_se/majabUwa_Dafga_se
stylishly	surucipUrNa_Dafga_se/PESanebala_Dafga_se
stylistically	SElIgawa_Dafga_se
suavely	cApalUsI_Bare_Dafga_se/BaxrawApUrvaka
subconsciously	avacewana_rUpa_se
subcutaneously	wvacA_ke_nIce_se
subjectively	vyakwiparaka_Dafga_se
sublimely	uwkqRta_Dafga_se/pUrI_waraha_se/awyaXika
subliminally	aXaHsAMvexanika_rUpa_se
submissively	xabbUpana_se/vinamrawApUrvaka
subsequently	bAxa_meM
subserviently	cApalUsI_Bare_Dafga_se
substantially	mUla_rUpa_se/majabUwI_se/kAPI_haxa_waka
subtly	sUkRmawA_se/sUkRma_rUpa_se
subversively	krAnwikArI_Dafga_se
successfully	saPalawApUrvaka
successively	kramaSaH/bArI-bArI_se
succinctly	sAragarBiwa_Dafga_se/safkRepa_meM
suddenly	acAnaka/akasmAw/acAnaka_hI
sufficiently	paryApwa_rUpa_se/paryApwa_mAwrA_meM/kAPI
suggestively	vyaFjanArWaka_Dafga_se/sAfkewika_Dafga_se
suicidally	AwmaGAwaka_rUpa_se
suitably	upayukwa_rUpa_se
sulkily	rUTa_kara
sullenly	KinnawA_se/muzha_PulAe
sultrily	kAmuka_Dafga_se
summarily	POrana_hI/binA_xerI_kie
sumptuously	vEBavapUrNa_Dafga_se/AlISAna_Dafga_se
super	bahuwa
superbly	bahuwa_SAnaxAra_Dafga_se
superciliously	vyafgyAwmaka_Dafga_se/nakacaDe_Dafga_se
superficially	sawahI_wOra_para
superfluously	awyaXikawA_se/anAvaSyaka_rUpa_se
superlatively	sarvowwama_rUpa_se/awyuwwama_Dafga_se
supernaturally	alOkika_rIwi_se/alOkika_rUpa_se
supernumerary	aXisafKya/anAvaSyaka
superstitiously	anXaviSvAsa_se/anXaviSvAsI_Dafga_se
supinely	Alasa_ke_sAWa/ciwa/bemana_se
supplely	lacIlepana_ke_sAWa
supply	lacIlepana_ke_sAWa
supposedly	kaWiwa_rUpa_se
supra	uparyukwa
sure	nisanxeha
surely	niSciwa_rUpa_se/niScaya_hI/avaSya
surgically	SalyakriyA_xvArA
surprisingly	AScaryajanaka_rUpa_se/hErAnI_kI_bAwa_hE
surreptitiously	corI-corI/najara_bacA_kara/luka-Cipa_kara
suspiciously	sanxehAspaxa_Dafga_se/SafkAspaxa_Dafga_se/Saka_kI_najara_se/aviSvAsapUrNa_Dafga_se
sweetly	pyAra_se/maXura-sA/ArAma_se/AkarRaka_Dafga_se
swiftly	wejI_se
swimmingly	binA_kisI_samasyA_ke/ArAma_se
symbolically	lAkRaNika_rUpa_se
symmetrically	sanwuliwa_rUpa_se
sympathetically	saMvexI_wanwrikA_wanwra_ke_anusAra/sahAnuBUwipUrvaka
synonymously	samAnArWI_rUpa_se
syntactically	vAkya_racanA_kI_xqRti_se
synthetically	saMSleRaNa_xvArA/kqwrima_rUpa_se
systematically	vyavasWiwa_rUpa_se/vyavasWiwa_Dafga_se/lagAwAra/karIne_se/jAnabUJa_kara
systemically	vyavasWiwa_rUpa_se/xEhika_rUpa_se
tacitly	akaWiwa_rUpa_se
taciturnly	KAmoSI_se/binA_AvAja_kie
tactfully	vyavahAra-kuSalawA_ke_sAWa/cawurAI_se
tactically	yukwisafgawa_Dafga_se/yukwipUrvaka/upAyawaH/sAmarika_xqRti_se
tactlessly	avyAvahArika_Dafga_se
tailor-made	pUrI_waraha_se_yogya
tamely	xabbUpana_ke_sAWa
tandem	eka_ke_pICe_eka
tangentially	UparI_wOra_se
tangibly	suniSciwa_rUpa_se
tanlespoonfull	badA_cammaca_Bara
tantalisingly	lalacAne_vAle_anxAja_meM
tantalizingly	lalacAne_vAle_anxAja_meM
tardily	AhiswA
tartly	wIKepana_se/katuwApUrvaka
tastefully	surucisampanna_Dafga_se
tastelessly	surucihIna_Dafga_se
tauntingly	majAka_udAne_ke_Dafga_se/ciDAne_ke_anxAja_meM
tautly	kasa_kara
tearfully	rowe-rowe/AzKoM_meM_AzsU_Bara_kara
teasingly	uwwejiwa_karawe_hue/uwsukawA_jagAwe_hue/ciDAne_ke_anxAja_meM
teaspoonful	cAya_cammaca_Bara
technically	wakanIkI_rUpa_se/wakanIka_kI_xqRti_se/kAnUnI_xqRti_se
technologically	wakanIkI_xqRti_se/wakanIka_ke_MaXyama_se
tediously	ukawAhata_ke_sAWa
telegraphically	wAra_ke_samAna_kama_SabxoM_meM
telepathically	xUrasaMvexana_se/pAreMxriya_jFAna_se
telescopically	telIskopa_ke_samAna
tellingly	spaRta_rUpa_se/praBAvaSAlI_Dafga_se
temperamentally	svaBAva_kI_xqRti_se
temperately	saMyama_ke_sAWa/PijUlaKarcI_ke_binA
temporarily	asWAyI_rUpa_se/Wode_xina
tenaciously	xqDawApUrvaka
tendenciously	pakRapAwapUrNa_Dafga_se
tenderly	prema_se/komalawA_se
tenfold	xasagunA
tensely	wanAvapUrNa_Dafga_se/becEnI_se
tentatively	AjamAiSI_wOra_para
tenuously	parisUkRma_rUpa_se
terminally	maraNAsanna_rUpa_se
termly	sAwrika
terribly	BayAnakawA_se/BaxxA/bahuwa_jyAxA/bahuwa
terrifically	SAnaxAra_Dafga_se
terrifyingly	darAvane_Dafga_se
territorially	kRewra_kI_xqRti_se
tersely	safkRipwa_rUpa_se
testily	cidacidA_kara
tete-a-tete	akeke_meM
than	kaba/se/kI_wulanA_meM
thankfully	kqwajFawA_ke_sAWa
thanks	ke_kAraNa
that	waka/iwanA/isa_haxa_waka/uwanA
the-same	samAna_rUpa_se
theatrically	nAtyarUpa_se/nAtakIya_Dafga_se/nAtakAxi_kI_xqRti_se
thematically	viRaya-vaswu_kI_xqRti_se
then	waba/waba_Pira/Pira_se/Pira_kaBI/kaba/isa_ke_awariwa/bAxa_meM/wawpaScAwa/wo
thence	vahAz_se/waxananwara/usa_kAraNa_se
thenceforth	waba_se
thenceforward	usa_samaya_se/waba_se
theologically	XarmaSAswrIya_Dafga_se/XarmaSAswra_kI_xqRti_se
theoretically	sixXAnwa_rUpa_se/waWyoM_ke_AXAra_para/sExXAnwika_rUpa_se
therapeutically	upacArAwmaka_uxxeSya_se
there	vahAz_para/vahAz/usa_sWAna_para/vaha{kriyA_SabxoM_ke_sAWa_bala_xene_ke_lie}
thereabout	usI_ke_Asa-pAsa/[usake]_Asa_pAsa
thereabouts	usI_ke_Asa-pAsa
thereafter	usake_bAxa_/waba_se/usa_ke_bAxa
thereby	usase/usake_kAraNa/PalasvarUpa
therefore	isalie/isa_waraha_se/awaH/awa:
therefrom	vahAz_se/usase
therein	usame/usameM
thereof	isakA/usakA
thereon	usa_para
thereto	usase
thereupon	usake_wawkAla_bAxa/usa_para/usake_bAxa
therewith	usake_bAxa
thermostatically	wApasWEwika_Dafga_se/wApasWApI_xvArA
thick	motApana_se/motapana_se/lagAwAra/Ganepana_se
thickly	saGanawApUrvaka/lagAwAra/gADI_parawa_ke_sAWa/BarrAI_huI_AvAja_meM
thin	bArikI_se
thinly	viralawA_se/uwsAhahIna_Dafga_se/pawalI_parawa_meM/pawale_tukadoM_meM/halkA_sA
third	wIsarA/wIsare_besa_para
thirdly	wIsarA
thirstily	pyAse_Dafga_se/AwurawApUrvaka
this	isese/iwanA
thither	uXara/usa_ora
thoroughly	pUrNa_rUpa_se/acCI_waraha_se/pUrNawa:
though	yaxyapi/hAlAzki
thoughtfully	vicAramagna_Dafga_se/sahqxayawApUrvaka
thoughtlessly	vicArahInawaH/binA_vicAre/binA_soce/beXyAnI_se/belihAjI_se/anasoce
thousand-fold	hajAra_gunA
threateningly	XamakAne_ke_anxAja_meM
three-fold	wigunA
threefold	wIna_gun/wigun
thrice	wIna_bAra
thrillingly	romAFcakArI_Dafga_se
throatily	BarrAI_AvAja_ke_sAWa
through	xvArA/SurU_se_AkIra_waka/se/pUrI_waraha_se/baxOlawa/acCI_waraha_se/eka_ora_se_xUsarI_ora/SurU_se_anwa_waka/prawibanXa_ko_wodawe_hue/anwa_waka/meM_se/meM/ke_xvArA/ke_mAXyama_se/ke_jarie/se_waka/Suru_se_anwa_waka/ke_kAraNa
throughout	SurU_se_anwa_waka/Suru_se_anwa_waka/pUrNawayA/pUre/Bara_meM/meM/pUre_meM
thus	isa_prakAra/isa_lie/isalie/isa_sImA_waka/isa_waraha
tidily	sAPa-suWare_Dafga_se
tight	kasakara
tightly	TasATasa/kasa_kara
till	waka
timelessly	SASvawa_rUpa_se/asAmayika_Dafga_se
timely	samaya_para/sahI_samaya_para
timidly	safkocapUrvaka/darawe-darawe
timorously	darawe-darawe
ting-a-ling	tina-tina
tiredly	wake_hue_anxAja_meM
tirelessly	aWaka_rUpa_se
tiresomely	WakAU_rUpa_se
to	hoSa_meM/banxa_avasWA_meM/banxa/ko/kI_aora/kI_ora/waka/kI/se/ke_mukAbale_meM/meM/se_milA_kara/ke_prawi
today	Aja/Ajakala
together	eka_sAWa/sAWa_meM/milA_kara/mila-jula_kara/ikataTe/eka-sAWa/ikaTTA/barAbara/sAWa-sAWa
tolerably	TIka-TAka_Dafga_se/TIka-TAka/kAmacalAU_Dafga_se
tolerantly	sahanaSIlawA_ke_sAWa
tomorrow	kala/kala{AnevAlA}
tonelessly	sapAta_svaroM_mem
tongue-in-cheek	majAka_meM
tonight	Aja_kI_rAwa_ko/Aja_rAwa_ko/Aja_rAwa
too	jyAxA_hI/Ora/haxa_se_aXika/BI/bahuwa_jyAxA/bahuwa_aXika/bahuwa/aXika/AvaSyakawA_se_aXika
toothlessly	binA_xAzwoM_ke
top-less	colI_Kolakara
topically	sWAnika_wOra_para
topless	binA_colI_ke
topographically	sWalAkqwi_kI_xqRti_se
toppingly	SAnaxAra_Dafga_se
tortuously	kutilawApUrvaka/jatilawApUrvaka
totally	pUrNa_rUpa_se/pUrI_waraha_se/hara_waraha_se
touchingly	marmasparSI_Dafga_se/hqxayasparSI_Dafga_se
toward	samIpa/howe-howe/uxyawa/lage/banawA_huA/kI_waraPa/ke_prawi/ke_pAsa/ke_lie/kI_ora/ke_viRaya_meM/ke_nikata
towards	kI_waraPa_se/kI_ora/howe-howe/waraPa/meM/kI_waraPa/ke_prawi/ke_pAsa/ke_lie
traditionally	paramparA_ke_anusAra/paramparAgawa_rUpa_se
tragically	SokapUrNa_warIke_se/xuKaxa_rUpa_se
traitorous	xeSaxrohAwmaka
traitorously	gaxxArI_se
tranquilly	SAnwipUrvaka/SAnwa_BAva_se
trans	ke_pAra
transparently	spaRta_rUpa_se/sAPa_wOra_para/pAraxarSI_Dafga_se
treacherously	XoKebAjI_se
treasonably	vixrohI_Dafga_se
tremendously	jabaraxaswa/awyaXika
tremulously	WaraWarAhata_ke_sAWa/kazpakazpAhata_ke_sAWa
trenchantly	praBAvaSAlI_Dafga_se
trickily	Cala-kapata_se
trickishly	XUrwawApUrNa_Dafga_se
triply	wIna_waraha_se/wIna_gunA/wigunA
triumphantly	vijayI_BAva_se
trivially	wucCa_Dafga_se/binA_prayAsa_kie
truculently	ugra_Dafga_se
true	TIka_warIke_se/saca_meM/sawyawA_pUrvaka
truly	sacamuca/vAswava_meM/sahI_arWoM_meM
trust	ImAnaxArI_se
trustfully	viSvAsI_Dafga_se/viSvAsapUrvaka
trustingly	viSvAsapUrvaka
truthfully	saccAI_se/ImAnaxarI_se
tumultuously	upaxravI_Dafga_se
tunefully	surIle_Dafga_se
tunelessly	besure_Dafga_se
turbulently	uwwejiwa_ho_kara/ugra_Dafga_se
tutorially	anuSikRaNa_xvArA
twice	xo_bAra/xuganA/xugunA
twinkling	palaka_Japakawe_hI
twofold	xugunA/xoharA
typically	viSiRta_rUpa_se
typographically	muxraNa_viRayaka_Dafga_se
ubiquitously	sarvavyApI_Dafga_se
ulterior	pare
ultimately	anwa_meM/mUlaBUwa_rUpa_se
ultrasonically	parAXvanika_viXi_se
unabashedly	nissafkocapUrvaka
unacceptably	asvIkArya_rUpa_se
unaccompanied	binA_kisI_sAWa_ke
unaccountably	binA_kisI_KAsa_vajaha_ke/akAraNa_hI
unachievably	alaBya_Dafga_se
unaffectedly	svABAvika_rUpa_se
unalterably	aparivarwanIya_Dafga_se
unambiguously	suspaRta_Dafga_se
unanimously	sarvasammawi_se
unapologetically	gEraSarmasAra_Dafga_se
unapparently	sanxigXawaH/aspaRtawaH
unappealingly	anAkarRaka_Dafga_se
unappreciatively	akqwajFawApUrvaka
unarguably	avivAxAspaxa_rUpa_se
unarticulately	sanxigXawaH/aspaRtawaH
unashamedly	nirlajjawA_se/nirlajjawApUrvaka/binA_safkoca_ke
unasked	binA_mAzge
unassailably	aparivarwanIya_Dafga_se
unassisted	binA_sahAyawA_ke
unattainably	alaBya_Dafga_se
unattractively	anAkarRaka_Dafga_se
unavoidably	aparihArya_rUpa_se
unawares	akasmAw/ekAeka/aprawyASiwa_rUpa_se/anajAne_meM/acAnaka
unbearably	asahanIya_Dafga_se
unbeknown	jAnakArI_ke_binA/binA_bawAe
unbeknownst	jAnakArI_ke_binA/binA_bawAe
unbelievably	aviSvasanIyawA_se
unbidden	binA_bulAyA/bina_bulAye/apane-Apa
uncannily	rahasyamaya_Dafga_se/awiprAkqwika_rUpa_se/alOkika_Dafga_se
unceasingly	lagAwAra
unceremoniously	anOpacArika_Dafga_se
uncertainly	ladaKadAwA_huA/anISciwa_Dafga_se
unchangeably	aparivarwanIya_Dafga_se
uncharacteristically	asAmAnya_rUpa_se
unchivalrously	aBaxra_Dafga_se
uncivilisedly	SiRtAcArahInawaH/aSiRtawaH/asaByawaH
uncivilizedly	SiRtAcArahInawaH/aSiRtawaH/asaByawaH
unclearly	sanxigXawaH/aspaRtawaH
uncomfortably	becEnI_ke_sAWa/pareSAnI_meM
uncommonly	asAXAraNa_rUpa_se/asAmAnya_rUpa_se
uncomparably	awulanIya_rUpa_se
uncomplainingly	sahanaSIlawApUrvaka/binA_SikAyawa_kie
uncompromisingly	samaJOwA_na_karane_vAle_Dafga_se/haTIle_Dafga_se
unconcernedly	uxAsInawApUrvaka/niSciMwawaH/ciMwAhInawaH/bePikrI_se/beKatake
unconditionally	binA_Sarwa_ke/spaRta_rUpa_se/aprawibanXiwa_rUpa_se
unconsciously	anajAne_meM
unconstitutionally	asaMvEXAnika_rUpa_se
uncontrollably	aniyanwraNIya_Dafga_se
uncontroversially	avivAxiwa_rUpa_se
unconventionally	aparamparAgawa_Dafga_se
unconvincingly	aviSvAsowpAxaka_Dafga_se
uncouthly	aSiRta_Dafga_se
uncritically	asamIkRAwmaka_Dafga_se
unctuously	KuSAmaxI_Dafga_se
undecipherably	apATya_Dafga_se
undemocratically	alokawAnwrika_Dafga_se
undeniably	avivAxiwa_rUpa_se
undependably	gEraBarosemanxa_Dafga_se
under	nIce/ke_nIce/se_kama/pAnI_ke_BIwara/meM/ke_xeKareKa_meM/ke_wahawa/ke_niyantraNa_meM/ke_nigarAnI_meM/ke_aXIna/ke_anxara/anxara/ke_wale
underarm	aNdaraArma/andara_Arma{kriketa}
undercover	gupwa_rUpa_se
underfoot	nIce/pEroM_wale/pAzva_wale
underground	Bumi_ke_wala_ke_nIce/gupwa
underhand	kapatapUrNa_Dafga_se
underhandedly	kapatapUrNa_Dafga_se
underneath	nIce/anxara_se/wale/ke_nIce
undersirably	avAFCanIya_Dafga_se
understandably	samaJa_meM_Ane_lAyaka_Dafga_se
understandingly	samaJane_ke_Dafga_se
undeservedly	anarjiwa_Dafga_se/anuciwa_rUpa_se
undesirably	avAFCanIya_Dafga_se
undisputedly	nirvivAxa_rUpa_se/avivAxiwa_rUpa_se
undoubtedly	nissanxeha/nissanxeha_rUpa_se/binA_kisI_sanxeha_ke/binA_Saka_va_Subaha
undramatically	binA_nAtakIyawA_ke
unduly	anuciwa_yA_ayogya_rIwi_se/anAvaSyaka_rUpa_se/awyanwa
uneasily	becEnI_se
uneconomically	GAte_para_calanA/KarcIle_Dafga_se/alABakara_Dafga_se
unemotionally	BAvahIna_Dafga_se
unendurably	asahanIya_Dafga_se
unenergetically	suswa_Dafga_se
unenviously	xveRahInawaH/IrRyAhInawaH/anasUyawaH
unequally	asamAna_rUpa_se/anuciwa_Dafga_se
unequivocally	suspaRta_Dafga_se
unerringly	binA_cUke
unethically	anEwika_Dafga_se
unevenly	viRamawApUrvaka/asamAna_rUpa_se/aniyamiwa_Dafga_se
uneventfully	binA_kisI_xurGatanA_ke
unexcitingly	nIrasa_Dafga_se
unexpectedly	akasmAwa/anapekRiwa_Dafga_se/acAnaka
unfailingly	hameSA/binA_nAgA_kie
unfairly	anyAyapUrNa_Dafga_se
unfaithfully	galawa_Dafga_se/bevaPAI_se/BakwihInawA_ke_sAWa
unfalteringly	binA_vicaliwa_hue
unfashionably	anaPESanebala_Dafga_se
unfavorably	prawikUla_Dafga_se/nakArAwmaka_Dafga_se
unfavourably	prawikUla_Dafga_se/nakArAwmaka_Dafga_se
unfeelingly	xayAhInawA_ke_sAWa/niRTurawApUrvaka
unfeignedly	sacamuca/akqwrima_Dafga_se
unflaggingly	aWaka_rUpa_se/XyAnapUrvaka/asImiwa_Dafga_se
unflinchingly	xqDawApUrvaka/binA_dare
unfocusedly	sanxigXawaH/aspaRtawaH
unforgettably	avismaraNIya_Dafga_se
unforgivably	akRamya_rUpa_se
unforgivingly	nirmamawApUrvaka/akRamASIla_Dafga_se
unfortunately	xurBAgya_se
ungallantly	aBaxra_Dafga_se
ungracefully	PUhada_Dafga_se/Baxxe_Dafga_se
ungraciously	aBaxrapUrNa/SiRtAcArahInawaH/Baxxe_Dafga_se/aSiRtawApUrvaka/aSiRtawaH/asaByawaH
ungrammatically	vyAkaraNa-viruxXa/avyAkaraNika_Dafga_se
ungratefully	akqwajFawApUrvaka
ungrudgingly	uxArawApUrvaka
unhappily	xuHKapUrvaka/uxAsI_ke_sAWa/aprasannawApUrvaka
unharmoniously	xurBAvanA_ke_sAWa/besure_Dafga_se
unhealthily	asvAsWyakara_Dafga_se
unhelpfully	asahAyawA_se/maxaxa_na_karawe_hue
unhesitatingly	beXadakawA_se/binA_hicakicAe
unhurriedly	binA_hadabadAe
unhygienically	asvAsWyakara_Dafga_se
uniformly	samarUpa_se/ekasamAna
unilaterally	ekapakRIyawA_se/ekawaraPA
unimaginably	akalpanIya_rUpa_se
unimaginatively	akalpanASIla_Dafga_se
unimpeachably	xAgarahiwa/avivAxAspaxa_Dafga_se
uninformatively	asUcanAwmaka_Dafga_se
uninhibitedly	unmukwa_Dafga_se
unintelligently	nAsamaJI_se
unintelligibly	sanxigXawaH/aspaRtawaH/aboXagamya_Dafga_se
unintentionally	anajAne_meM/XoKe_se
uninterestingly	nIrasa_Dafga_se/arocaka_Dafga_se
uninterruptedly	nirviGna_rUpa_se
uninvitedly	bina_bulAye/animanwriwa_rUpa_se
uninviting	aprIwikara
uninvitingly	anAkarRaka_rUpa_se
uniquely	viSiRta_rUpa_se/vilakRaNa_Dafga_se/alaga-alaga
unitedly	eka_sAWa
universally	sarvawra/saBI_ke_xvArA
unjustifiably	anuciwa_rUpa_se/akAraNa_hI
unjustly	anyAya_se/anyAyapUrNa_Dafga_se/aXarma_se
unkindly	nirxayawA_se/kaTorawA_se
unknowingly	anajAne_me/XoKe_se/anajAne_meM/binA_jAne_bUJe
unlawfully	gErakAnUnI_Dazga_se/gErakAnUnI_Dafga_se/avEXa_rUpa_se
unlike	se_Binna/prawikUla/ke_viparIwa
unluckily	xurBAgyavaSa
unmanageably	aniyanwraNIya_Dafga_se
unmelodiously	mAXuryahIna_Dafga_se
unmemorably	vismaraNIya_Dafga_se
unmercifully	nirxayawApUrvaka
unmethodically	viXihInawaH/kuviXipUrvaka/bewarIke
unmindfully	beparavAhI_se
unmistakably	suspaRtawA_se/spaRtawaH
unmistakeably	spaRtawaH
unmusically	besure_Dafga_se
unnaturally	asvABAvika_rUpa_se/kqwrima_rUpa_se/asvABAvika_Dafga_se/asahaja_rUpa_se/aprAkqwika_rUpa_se
unnecessarily	anAvaSyaka_rUpa_se/vyarWa_meM/bekAra_meM/bekAra
unnervingly	hawowsAha_se/darAvane_rUpa_se
unnoticeably	awisUkRma_rUpa_se/alakRiwa_rUpa_se
unobtrusively	sahaja_rUpa_se
unofficially	anAXikArika
unoriginally	amOlika_rUpa_se
unpardonably	akRamya_rUpa_se
unpleasantly	arUcikara_Dafga_se
unprecedentedly	aBUwapUrva_Dafga_se
unpredictably	aniSciwa_Dafga_se
unpretentiously	sAxe_Dafga_se/Adambararahiwa_Dafga_se
unproductively	niRPalawA_se/vyarWa_meM/anuwpAxaka_rUpa_se
unprofessionally	avyavasAyika_Dazga_se/anuciwa_Dafga_se
unprofitably	bePAyaxA_se/vyarWa
unpropitiously	ananukUla_rUpa_se
unqualifiedly	ayogyawApUrvaka
unquestionably	binA_koI_SafkA_se/niSciwa_rUpa_se/avivAxAspaxa_Dafga_se
unquestioningly	binA_kuCa_pUCe
unquietly	aSAnwa_Dafga_se
unquote	xUsarI_waraha_se
unreadably	apaTanIya_Dafga_se
unrealistically	ayaWArWavAxI_Dafga_se
unreasonably	avivekawA_se/anuciwa_Dafga_se/amaryAxiwa_rUpa_se
unreasoningly	avivekapUrNa_Dafga_se/asafgawa_Dafga_se
unrecognisably	AsAnI_se_na_pahacAne_jAne_yogya_Dafga_se
unrecognizably	AsAnI_se_na_pahacAne_jAne_yogya_Dafga_se
unrefinedly	SiRtAcArahInawaH/aSiRtawaH/asaByawaH
unrelentingly	niRTura_Dafga_se/lagAwAra
unreliably	gEraBarosemanxa_Dafga_se
unremarkably	sAXAraNa_Dafga_se
unremittingly	lagAwAra
unrepentantly	binA_paCawAve_ke
unreproducibly	anoKe_Dafga_se/ananukaraNIya_Dafga_se
unreservedly	pUrNarUpa_se/Kula_kara/spaRtawA_se
unrestrainedly	asaMyamiwa_Dafga_se
unrighteously	anyAyasafgawa_Dafga_se
unromantically	gEra-rUmAnI_Dafga_se
unsatiably	awqpya_rUpa_se/asanwuRta_Dafga_se
unsatisfactorily	asanwoRajanaka_Dafga_se
unscientifically	avEjFAnika_Dafga_se
unscrupulously	anEwikawA_se/anEwika_Dafga_se
unseasonably	bemOsamI_Dafga_se
unseen	cupake_se
unselfconsciously	binA_safkoca_ke/asafkocaSIla_Dafga_se
unselfishly	nissvArWa_BAva_se
unsentimentally	aBAvuka_Dafga_se
unshakably	binA_vicaliwa_hue
unsmilingly	binA_muskurAe
unsociably	gEramilanasAra_Dafga_se/asamAjaSIla_Dafga_se
unsparingly	uxArawA_se/uxArawApUrvaka/saKwI_se/katu_AlocanApUrNa_Dafga_se
unspeakably	akaWanIyawA_se/akaWanIya_rUpa_se
unsportingly	Kela-BAvanA_ke_viparIwa_Dafga_se
unsteadily	asWirawA_se/ladaKadAwA_huA
unstintingly	pracurawA/uxArawApUrvaka
unsuccessfully	asaPalawA_se/asaPalawApUrvaka
unsuitably	anupayukwawA_se/anupayukwa_rUpa_se
unsurprisingly	anAScaryawA_se/aAScaryajanakapUrvaka
unsuspectingly	asanxehaSIla_BAva_se
unswervingly	sIXA/atala_rUpa_se
unsymmetrically	asamamiwIya_Dafga_se
unsympathetically	asahAnuBUwipUrNa_Dafga_se
unsystematically	avyavasWiwawA_se/kramahInawaH/avyavasWiwawaH/avyavasWiwa_Dafga_se/akramawaH
unthinkably	akalpanIya_rUpa_se
unthinking	vicAraSUnya_Dafga_se/vicArahInawaH/binA_vicAre/binA_soce/beXyAnI_se/belihAjI_se/anasoce
unthinkingly	anajAne/vicAraSUnya_Dafga_se/vicArahInawaH/binA_vicAre/binA_soce/beXyAnI_se/belihAjI_se/anasoce
untidily	ganxe_Dafga_se/avyavasWiwa_Dafga_se
until	waka/jaba_waka
untimely	asamaya_meM
unto	waka
untruly	miWyA_Dafga_se
untruthfully	asawyawA_se/JUTa-mUTa
untypically	asAmAnya_rUpa_se
ununderstandably	aboXagamya_Dafga_se
unusually	asamAnyawaH/asAXAraNa_rUpa_se/asAmAnya_rUpa_se/aprAyika_rUpa_se
unutterably	akaWyawA_se/akaWanIya_rUpa_se
unversally	sarvasammawi_se
unwantedly	bina_bulAye/animanwriwa_rUpa_se
unwarily	asAvaXAnI_se
unwarrantably	asafgawa_Dafga_se
unwaveringly	xqDawA_se/xqDawApUrvaka
unwillingly	anicCA_se/bemana_se/anicCApUrvaka
unwisely	mUrKawA_se/mUrKawApUrNa_Dafga_se/avivekapUrNa_Dafga_se/anupayukwa_rUpa_se
unwittingly	anajAne_se/XoKe_se/anajAne_meM
unwontedly	asAmAnya_Dafga_se
unworthily	ayogyawApUrvaka
up-country	xehAwa_meM
up-market	mahafgAI_meM
up	Upara_kI_ora/UrXva/upara_kI_ora/Upara/pUrI_waraha_se/kasa_ke/Age/ke_Upara/ke_upara/para
upfield	viroXI_xala_meM
uphill	Upara_kI_ora/pahAdI_para
upon	ke_Upara/para/najaxIka/UzcA
uppermost	sarvocca_sWAna_yA_paxa_iwyAxi_me
upright	sIXe
upriver	pravAha_ke_viparIwa_xiSA_meM
uproariously	ho_halle_ke_sAWa/bahuwa_hI
upstage	nepaWya_kI_waraPa
upstairs	ximAga_se/UparI_maFjila_para/UparI_maFjila
upstate	uwwara_meM/Sahara_ke_xUra_kA_ilAkA
upstream	ujAna/pravAha_ke_viparIwa_xiSA_meM
uptown	rihAiSI/muKya_Sahara_se_xUra
upward	Upara_kI_waraPa/Upara/mahazgAI_kI_ora
upwardly	Upara_kI_waraPa
upwards-of	se_aXika
upwards	Upara_kI_waraPa/Upara/mahazgAI_kI_ora
upwind	havA_kI_xiSA_kI_ora/havA_ke_xiSA_kI_ora
urbanely	SiRtawA_se
urgently	wAkIxI_Dafga_se/avilamba/AgrahapUrNa_Dafga_se
usefully	upayogI_Dafga_se
uselessly	bekAra_meM
usually	Ama_wOra_para/aksara/sAXAraNa_rIwi_se/sAmAnyawaH
utterly	sampUrNa_rUpa_se/pUrNa_rUpa_se
vacantly	BAvaSUnya_Dafga_se
vacuously	KoKale_Dafga_se
vaguely	sanxigXawaH/aspaRtawaH/aspaRta_rUpa_se
vainly	vyarWa_meM/vyarWa
valiantly	vIrawApUrvaka
validly	vEXa_Dafga_se
valorously	vIrawApUrvaka
variably	parivarwanaSIla_rUpa_se
variously	Binna_Binna_prakAra_se/viviXa_rUpa_se
vastly	bade_rUpa_se/bahuwa_aXika
vauntingly	SeKI_mArawe_hue
vehemently	wIvra_rUpa_se/joraxAra_Dafga_se
vengefully	prawiSoXa_kI_BAvanA_se
venomously	viRElepana_se
verbally	mOKika_rUpa_meM/mOKika_rUpa_se/kriyA_ke_rUpa_meM
verbatim	SabxaSaH/laPja-ba-laPja
verbosely	SabxAdambarapUrNawA_se
verily	vaswuwaH
versus	ke_mukAbale/viparIwa/viruxXa/banAma
vertically	lambAkAra_meM
very	bahuwa/ekaxama/bilakula_vahI/bahuwa_hI/awyanwa/behaxa
via	kI_rAha_se/se_hokara/ke_xvArA
vicariously	sWAnApanna_rUpa_se
vice-versa	ulate
viciously	krUrawApUrvaka
victoriously	vijayI_Dafga_se
videlicet	yaWA
vigilantly	sawarkawApUrvaka
vigorously	uwsAha_se/joSIle_Dafge_se/joSapUrNa_Dafga_se
vilely	GqNiwa_Dafga_se
vindictively	prawiSoXa_kI_BAvanA_se
violently	hiMsAwmaka_Dafga_se
virtually	lagaBaga/lagaBaga{vAswava_meM_nahIM}
virtuously	saxAcAriwA_se/paviwrawApUrvaka
virulently	ugra_Dafga_se
vis-a-vis	Amane-sAmane/ke_sanxarBa_meM/kI_wulanA_meM/ke_viRaya_meM
viscerally	asafgawa_Dafga_se/AnwarAfgika_rUpa_se
viscidly	cipacipe_Dafga_se
visibly	spaRta_rUpa_se/prawyakRawaH/prawyakRa_rUpa_se
visually	AzKoM_se/xqRtigawa_rUpa_se
vitally	mahawwvapUrNa_rUpa_se/awyAvaSyaka_rUpa_se
vitriolically	wIKepana_se/katuwApUrvaka
viva-voce	jabAnI
vivace	joSapUrNa_Dafga_se
vivaciously	joSapUrNa_Dafga_se
vividly	sajIva_Dafga_se
viz.	yaWA
vocally	mOKika_rUpa_se/SAbxika_rUpa_se
vocationally	vyAvasAyika_rUpa_se
vociferously	Sora_sahiwa/Sora-gula_ke_sAWa
volcanically	jvAlAmuKI_se
volitionally	svecCayA/svecCawaH/svecCA_se/svecCApUrvaka
volubly	bAwUnI_Dafga_se
volumetrically	Ayawana_kI_xqRti_se
voluminously	vipulawA_se
voluntarily	svecCA_se/svecCayA/svecCawaH/svecCApUrvaka/apane-Apa
voluptuously	vilAsiwApUrvaka/AkarRaka_Dafga_se
voraciously	uwsukawA_se_/lAlacI_kI_waraha
voyeuristically	xqSyarawika_ke_Dafga_se
vulgarly	asaByawA_se/aSlIlawApUrvaka/aSlIla_Dafga_se
vulnerably	asurakRiwa_rUpa_se
wackily	pAgaloM_kI_waraha_se
wafer-thin	bahuwa_pawalA
waggishly	majAkiyA_Dafga_se
waist-deep	kamara_waka_gahare
waist-high	kamara_waka
wanly	PIke_Dafga_se
wanting	ke_sivA
wantonly	svcCanxawApUrvaka/nirxayawApUrvaka
warily	cOkasI_se/sawarkawApUrvaka
warmly	uwsAha_se/sneha_se/garmajoSI_se/garama_Dafga_se
wastefully	apavyayI_Dafga_se
watchfully	sawarkawApUrvaka
way	bahuwa_hI_xUra/bahuwa_hI/bahuwa
weakly	kamajorI_se/xurbalawApUrvaka/WodA-bahuwa/PIke_Dafga_se
wealthily	samqxXa_rUpa_se
wearily	wake_hue_anxAja_meM
week-long	sapwAhaBara
weekly	sapwAha_meM_eka_bAra/prawi_sapwAha
weightily	BArIpana_ke_sAWa/BArI-Barakama_anxAja_meM
well-nigh	lagaBaga
well-timed	sahI_samaya_para
well	SAyaxa/sahaja_hI/pUrI_waraha_se/lagaBaga/bahuwa_jyAxA/bahuwa/acCI_waraha_se/acCe_se/acCI_waraha
west	paScima_kI_ora
westerly	paScima_se/paScima_kI_ora
westward	paScima_kI_ora
westwards	paScima_kI_ora
whacking	behaxa
whatsoever	kuCa_BI
wheezily	Garra-Garra_karawe_hue
wheezingly	Garra-Garra_karawe_hue
when	kaba/jaba-jaba/jaba
whence	kahAz_se
whenever	jaba_kaBI/kaba
where	kahAz/jahAz
whereabouts	TikAnA
whereby	jisake_xvArA/jisase/jisameM
wherein	jisameM
whereupon	jisa_para
wherever	jahAz_kahIM/kahAz
whimsically	manamOjI_Dafga_se
whiningly	SikAyawI_Dafga_se/ririyAwe_hue
whither	kahAz_para
whole	pUrNawayA/pUrI_waraha_se
wholeheartedly	pUre_xila_se
wholesale	Woka_BAva_se
wholesomely	acCI_waraha_se
wholly	pUrI_waraha_se
whopping	bahuwa_jyAxA
why	kyoM/kisalie
wickedly	xuRtawA_se/pApapUrNa_Dafga_se
wide-eyed	AzKe_PAde
wide	pUrI_waraha_se
widely	vyApaka_rUpa_se/paryApwa_mAwrA_meM/xUra-xUra_waka/bahuwa_se_logoM_xvArA/bahuwa_aXika/viSAla_kRewra_meM
wild	jafgalI_Dafga_se/aniyanwriwa_rUpa_se
wildly	SiRtAcArahInawaH/pAgaloM_ke_samAna/bahuwa_hI/aSiRtawaH/asaByawaH
wilfully	jAnawe-bUJawe/jAna-bUJa_kara
willfully	jAnawe-bUJawe/jAna-bUJa_kara
willingly	svecCA_pUrvaka/svecCayA/svecCawaH/svecCApUrvaka/sveCA_se
willy-nilly	jabarxaswI/avyavasWiwa_Dafga_se
windily	SabxAdambarapUrNawA_se
windward	pavanABimuKa
winsomely	luBAvane_Dafga_se/AkarRaka_Dafga_se
wisely	samaJaxArI_se/buxXimawwApUrvaka
wishfully	icCA_se
wistfully	uwkaNTA_se/uwkaNTApUrvaka
with	ke_sAWa/se_yukwa/se/milAkara/meM/ke_xiSA_meM/ke_prawi/ke_mAmale_meM/ke_kAraNa/ke_bAvajUxa/ke_pAsa/ke_sAWa_sAWa/kI_xiSA_meM/ka_bAvajUxa
withal	waba_BI/sAWa_hI/Pira_BI
witheringly	wiraskArapUrNa_Dafga_se/viXvaMsakArI_Dafga_se/avajFApUrNa_Dafga_se
within	BIwara/mana_meM/mana_hI_mana/ke_anwargawa/ke_anxara/anxara/meM/ke_BIwara/kI_sImA_ke_anxara
without	bAhara/ke_binA/Codakara/binA/na
wittily	vinoxapUrNa_Dafga_se
wittingly	jAna-bUJa_kara
woefully	uxAsI_se/SokAkula_Dafga_se/Kexajanaka_Dafga_se
wolfishly	Bedie_kI_waraha
wonderfully	bahuwa_acCe_Dafga_se
wonderingly	uwsukawApUrvaka/praSnAwmaka_Dafga_se
wondrous	AScaryajanaka_rUpa_se
wondrously	SAnaxAra_Dafga_se/AScaryajanaka_rUpa_se
woodenly	binA_loca_ke/Baxxe_Dafga_se/BAvaSUnya_Dafga_se
wordily	SabxAdambarapUrNawA_se
wordlessly	mUkawApUrvaka/KAmoSI_se/cupacApa
worldwide	viSva_Bara_meM/pUre_viSva_meM/viSvavyApI
worriedly	uxvignawApUrvaka/uxvignawaH/ciMwiwawaH
worryingly	ciMwAjanaka_Dafga_se
worse	Ora_BI_bure_prakAra_se/Ora_KarAba/bahuwa_weja
worst	sabase_KarAba
worthily	uciwa_Dafga_se
worthlessly	vyarWa_rUpa_se/bekAra_Dafga_se
wrathfully	kroXapUrvaka/gusse_se
wretchedly	xuKI_ho_kara/xayanIya_BAva_se
wrong	galawa/galawa_xiSA_meM/galawa_Dafga_se/gadabada_Dafga_se/anEwikawApUrvaka/anEwikawApUrNa_Dafga_se/galawapUrNa
wrongfully	anuciwa_rUpa_se/anaXikqwa_rUpa_se
wrongheadedly	XqRtawA_se/XqRtawApUrvaka
wrongly	galawa_Dafga_se/galawa/anuciwa_Dafga_se
wryly	vyafgyapUrvaka/vyafgyapUrNa_Dafga_se
yea	hAz
yeah	hAz
yearly	prawi_varRa/hara_sAla
yearningly	lalaka_ke_sAWa
yep	hAz
yesterday	kala/kala_ko
yet	aBI_waka/waWApi/waba_waka/waba_BI/Ora_BI/Ora/kisI_xina/isa_samaya/anwawogawvA/AkirakAra/aBI_BI/aBI/aba_waka_kA/aba_waka/aba
yieldingly	AjFAkArI_Dafga_se
yon	vahAz/uXara/usa_ora
yonder	vahAz/uXara/usa_ora/pare
youthfully	yuvAoM_kI_waraha
zealously	uwsAhapUrvaka/saragarmI_se
zestfully	uwsAhapUrvaka/joSapUrNa_Dafga_see/joSa_ke_sAWa
zestily	uwsAhapUrvaka/joSapUrNa_Dafga_see/joSa_ke_sAWa
zigzag	teDA-meDA/kutila_gawi_se
zoogeographically	prANiBUgolIya_rUpa_se
zygotically	yugmanaja_rUpa_se
