	
0_ho_jAwA_hE	0_ho_jAwA_hE
0_xenA_padA	0_xenA_padA
cAhawA_hE	nA_cAhawA_hE
cAhawA_hUz	nA_cAhawA_hE
cAhawe_hEM	nA_cAhawA_hE
cAhawe_ho	nA_cAhawA_hE
cAhawI_hEM	nA_cAhawA_hE
cAhawI_hE	nA_cAhawA_hE
cAhawI_ho	nA_cAhawA_hE
cAhawI_hUz	nA_cAhawA_hE
cAhie	nA_cAhie
cAhie_WA	nA_cAhie_WA
cAhie_We	nA_cAhie_WA
cAhie_WIM	nA_cAhie_WA
cAhie_WI	nA_cAhie_WA
cukA	0_cukA
cukA_hE	0_cukA_hE
cukA_hogA	0_cukA_hogA
cukA_hoUzgA	0_cukA_hogA
cukA_hUz	0_cukA_hE
cukane_ke_bAxa	0_cukane_ke_bAxa
cukA_WA	0_cukA_WA
cuke	0_cukA
cuke_hEM	0_cukA_hE
cuke_ho	0_cukA_hE
cuke_hoge	0_cukA_hogA
cuke_hoMge	0_cukA_hogA
cuke_We	0_cukA_WA
cukI	0_cukA
cukI_hE	0_cukA_hE
cukI_hogI	0_cukA_hogA
cukI_hoUzgI	0_cukA_hogA
cukI_hUz	0_cukA_hE
cukIM	0_cukA
cukIM_hEM	0_cukA_hE
cukIM_ho	0_cukA_hE
cukIM_hoMgI	0_cukA_hogA
cukIM_hoogI	0_cukA_hogA
cukIM_WIM	0_cukA_WA
cukI_WI	0_cukA_WA
gayA_hE	yA_gayA_hE
gayA_hoUzgA	yA_gayA_hogA
gayA_hUz	yA_gayA_hE
gayA_WA	0_gayA_WA
gayA_WA	yA_gayA_WA
gayA	yA_gayA
gaye_hEM	yA_gayA_hE
gaye_hoUzgA	yA_gayA_hogA
gaye_We	0_gayA_WA
gaye_We	yA_gayA_WA
gaye	yA_gayA
gayI_hE	yA_gayA_hE
gayI_hoUzgA	yA_gayA_hogA
gayIM_hEM	yA_gayA_hE
gayIM_hoUzgA	yA_gayA_hogA
gayIM_WIM	0_gayA_WA
gayIM_WIM	yA_gayA_WA
gayIM	yA_gayA
gayI_WI	0_gayA_WA
gayI_WI	yA_gayA_WA
gayI	yA_gayA
hE	hE
hEM	hE
hEM	nA_hE
hEM	wA_hE
hEM	yA_hE
hE	nA_hE
hE	wA_hE
hE	yA_hE
hI_hEM	nA_hI_hE
hI_hE	nA_hI_hE
hogA	nA_hogA
hogA	yA_hogA
hoge	yA_hogA
hogI	nA_hogA
hogI	yA_hogA
ho	hE
hoMge	nA_hogA
hoMge	yA_hogA
hoMgI	nA_hogA
hoMgI	yA_hogA
hoogI	yA_hogA
hoUzgA	yA_hogA
hoUzgI	yA_hogA
ho	wA_hE
ho	wA_ho
howA	yA_howA
howe	yA_howA
howIM	yA_howA
howI	yA_howA
ho	yA_hE
ho	yA_ho
huA_hE	yA_huA_hE
huA_honA	yA_huA_honA
huA_ho_sakawA_hE	yA_huA_ho_sakawA_hE
huA_ho_sakawA_hUM	yA_huA_ho_sakawA_hE
huA_ho	yA_huA_hE
huA_hUz	yA_huA_hE
huA	wA_huA
huA_WA	yA_huA_WA
huA	yA_huA
hue_hEM	yA_huA_hE
hue_honA	yA_huA_honA
hue_ho_sakawe_hEM	yA_huA_ho_sakawA_hE
hue_ho_sakawe_ho	yA_huA_ho_sakawA_hE
hue_ho	yA_huA_hE
hue	wA_huA
hue_We	yA_huA_WA
hue	yA_huA
huI_hEM	yA_huA_hE
huI_hE	yA_huA_hE
huI_honA	yA_huA_honA
huI_ho_sakawI_hEM	yA_huA_ho_sakawA_hE
huI_ho_sakawI_hE	yA_huA_ho_sakawA_hE
huI_ho_sakawI_ho	yA_huA_ho_sakawA_hE
huI_ho_sakawI_hUM	yA_huA_ho_sakawA_hE
huI_ho	yA_huA_hE
huI_hUz	yA_huA_hE
huI_hUz	yA_huA_WA
huIM_honA	yA_huA_honA
huIM	wA_huA
huIM	yA_huA
huI	wA_huA
huI_WIM	yA_huA_WA
huI_WI	yA_huA_WA
huI	yA_huA
hUz	hE
hUz	wA_hE
hUz	yA_hE
jAegA	0_jAyegA
jAegA	yA_jAyegA
jAegI	0_jAyegA
jAegI	yA_jAyegA
jAeMge	0_jAyegA
jAeMge	yA_jAyegA
jAeMgI	0_jAyegA
jAeMgI	yA_jAyegA
jAnA_cAhie	0_jAnA_cAhie
jAnA_cAhie	yA_jAnA_cAhie
jAnA_hE	yA_jAnA_hE
jAnA_hUz	yA_jAnA_hE
jAnA_WA	yA_jAnA_WA
jAnA	yA_jAnA
jAne_cAhie	yA_jAnA_cAhie
jAne_hEM	yA_jAnA_hE
jAne_ho	yA_jAnA_hE
jAneM	yA_jAnA
jAne_We	yA_jAnA_WA
jAne	yA_jAnA
jAnI_cAhie	yA_jAnA_cAhie
jAnI_hEM	yA_jAnA_hE
jAnI_hE	yA_jAnA_hE
jAnI_hUz	yA_jAnA_hE
jAnIM_cAhie	yA_jAnA_cAhie
jAnIM_WIM	yA_jAnA_WA
jAnIM	yA_jAnA
jAnI_WI	yA_jAnA_WA
jAnI	yA_jAnA
jAoge	0_jAyegA
jAoge	yA_jAyegA
jAogI	0_jAyegA
jAogI	yA_jAyegA
jA_rahA_hE	yA_jA_rahA_hE
jA_rahA_WA	yA_jA_rahA_WA
jA_rahe_hEM	yA_jA_rahA_hE
jA_rahe_We	yA_jA_rahA_WA
jA_rahI_hE	yA_jA_rahA_hE
jA_rahIM_hEM	yA_jA_rahA_hE
jA_rahIM_WIM	yA_jA_rahA_WA
jA_rahI_WI	yA_jA_rahA_WA
jA_sakawA_hE	yA_jA_sakawA_hE
jA_sakawA_WA	yA_jA_sakawA_WA
jA_sakawe_hEM	yA_jA_sakawA_hE
jA_sakawe_We	yA_jA_sakawA_WA
jA_sakawI_hE	yA_jA_sakawA_hE
jA_sakawIM_hEM	yA_jA_sakawA_hE
jA_sakawIM_WIM	yA_jA_sakawA_WA
jA_sakawI_WI	yA_jA_sakawA_WA
jA_sakA	yA_jA_sakA
jA_sake	yA_jA_sakA
jA_sakIM	yA_jA_sakA
jA_sakI	yA_jA_sakA
jAUzgA	0_jAyegA
jAUzgA	yA_jAyegA
jAUzgI	0_jAyegA
jAUzgI	yA_jAyegA
jAwA_hE	yA_jAwA_hE
jAwA_hUM	yA_jAwA_hE
jAwA_WA	yA_jAwA_WA
jAwe_hEM	yA_jAwA_hE
jAwe_We	yA_jAwA_WA
jAwI_hE	yA_jAwA_hE
jAwIM_hEM	yA_jAwA_hE
jAwIM_WIM	yA_jAwA_WA
jAwI_WI	yA_jAwA_WA
KA	0
KAIM	yA
KAI	yA
kA_niScaya_kie	ne_kA_niScaya_kiyA
kA_niScaya_kiyA	ne_kA_niScaya_kiyA
KAo	subj
kara	0_kara
karawA_WA	yA_karawA_WA
karawe_We	yA_karawA_WA
karawIM_WIM	yA_karawA_WA
karawI_WI	yA_karawA_WA
KAUz	subj
KAyA	yA
KAyeM	subj
KAye	subj
KAye	yA
ke_bAre_meM	ne_ke_bAre_meM
ke_bAxa	ne_ke_bAxa
ke_bIca	ne_ke_bIca
ke_lie	ne_ke_lie
ke_pahale	ne_ke_pahale
ke_pare	ne_ke_pare
ke_viruxXa	ne_ke_viruxXa
kI_jarUrawa_hE	nA_kI_jarUrawa_hE
kI_jarUrawa_hE	ne_kI_jarUrawa_hE
kI_jarUrawa_nahIM_hE	nA_kI_jarUrawa_nahIM_hE
kI_jarUrawa_nahIM_hE	ne_kI_jarUrawa_nahIM_hE
kI_jarUrawa_pada_sakawI_hE	ne_kI_jarUrawa_pada_sakawI_hE
kI_niScaya_kie	ne_kA_niScaya_kiyA
kI_niScaya_kI	ne_kA_niScaya_kiyA
kI_sWiwi_meM_hEM	ne_kI_sWiwi_meM_ho
kI_sWiwi_meM_hE	ne_kI_sWiwi_meM_ho
kI_sWiwi_meM_ho	ne_kI_sWiwi_meM_ho
kI_sWiwi_meM_hUz	ne_kI_sWiwi_meM_ho
lie_hoMge	0_liyA_hogA
lI_hogI	0_liyA_hogA
lIM_hoMgI	0_liyA_hogA
liyA_hogA	0_liyA_hogA
meM	ne_meM
nA1_padegA	nA1_padegA
nA1_padegA_WA	nA1_padegA_WA
nA2_padegA	nA2_padegA
nahIM	nahIM
nahIM_padA	nahIM_padA
nahIM_padawA_WA	nahIM_padawA_WA
nA_hI_WA	nA_hI_WA
nA_kA_cAhie_honA	nA_kA_cAhie_honA
nA_ke_bAxa	nA_ke_bAxa
nA_ke_kAraNa	nA_ke_kAraNa
nA_kI_himmawa_hE	nA_kI_himmawa_hE
nA_kI_himmawa_WI	nA_kI_himmawa_WI
nA_kI_jarUrawa_hogI	nA_kI_jarUrawa_hogI
nA_pasanxa_kara_gA	nA_pasanxa_kara_gA
nA_pasanxa_karawA_hE	nA_pasanxa_karawA_hE
nA_pasanxa_karawA_WA	nA_pasanxa_karawA_WA
nA_pasanxa_nahIM_karawA_hE	nA_pasanxa_nahIM_karawA_hE
nA_pasanxa_nahIM_karawA_WA	nA_pasanxa_nahIM_karawA_WA
nA_unako_xo	nA_unako_xo
nA_usako	nA_usako_xo
padA	nA_padA
padawA_WA	nA_padawA_WA
padawe_We	nA_padawA_WA
padawIM_WIM	nA_padawA_WA
padawI_WI	nA_padawA_WA
padegA	nA_padegA
padegI	nA_padegA
padeMge	nA_padegA
padeMgI	nA_padegA
pade	nA_padA
padIM	nA_padA
padI	nA_padA
pAoge	0_pAyegA
pAogI	0_pAyegA
para	ne_para
pAUzgA	0_pAyegA
pAUzgI	0_pAyegA
pAwA_hE	0_pAwA_hE
pAwA_hUz	0_pAwA_hE
pAwA_WA	0_pAwA_wA
pAwe_hEM	0_pAwA_hE
pAwe_ho	0_pAwA_hE
pAwe_We	0_pAwA_wA
pAwI_hE	0_pAwA_hE
pAwI_hEM	0_pAwA_hE
pAwI_ho	0_pAwA_hE
pAwI_hUz	0_pAwA_hE
pAwI_WI	0_pAwA_wA
pAwI_WIM	0_pAwA_wA
pAyegA	0_pAyegA
pAyegI	0_pAyegA
pAyeMge	0_pAyegA
pAyeMgI	0_pAyegA
rahA_hE	0_rahA_hE
rahA_hE	wA_rahA_hE
rahA_hogA	0_rahA_hogA
rahA_hogA	wA_rahA_hogA
rahA_hoUzgA	0_rahA_hogA
rahA_hoUzgA	wA_rahA_hogA
rahA_ho	wA_rahA_ho
rahA_hUz	0_rahA_hE
rahA_hUz	wA_rahA_hE
rahanA_hE	we_rahanA_hE
raha_sakA	raha_sakA
raha_sakawA	raha_sakawA
rahA_WA	0_rahA_WA
rahawA_hE	wA_rahawA_hE
rahawA_hUz	wA_rahawA_hE
rahA	wA_rahA
rahA_WA	wA_rahA_WA
rahawe_hEM	wA_rahawA_hE
rahawe_ho	wA_rahawA_hE
rahawI_hE	wA_rahawA_hE
rahawI_hUz	wA_rahawA_hE
rahawIM_hEM	wA_rahawA_hE
rahawIM_ho	wA_rahawA_hE
rahegA	wA_rahegA
rahegA	wA_rahUzgA
rahegI	wA_rahegA
rahegI	wA_rahUzgA
rahe_hEM	0_rahA_hE
rahe_hEM	wA_rahA_hE
rahe_ho	0_rahA_hE
rahe_hoge	0_rahA_hogA
rahe_hoge	wA_rahA_hogA
rahe_hoMge	0_rahA_hogA
rahe_hoMge	wA_rahA_hogA
rahe_ho	wA_rahA_hE
rahe_ho	wA_rahA_ho
raheMge	wA_rahegA
raheMge	wA_rahUzgA
raheMgI	wA_rahegA
raheMgI	wA_rahUzgA
rahe	wA_rahA
rahe_We	0_rahA_WA
rahe_We	wA_rahA_WA
rahI_hE	0_rahA_hE
rahI_hE	wA_rahA_hE
rahI_hogI	0_rahA_hogA
rahI_hogI	wA_rahA_hogA
rahI_hoUzgI	0_rahA_hogA
rahI_hoUzgI	wA_rahA_hogA
rahI_ho	wA_rahA_ho
rahI_hUz	0_rahA_hE
rahI_hUz	wA_rahA_hE
rahIM_hEM	0_rahA_hE
rahIM_hEM	wA_rahA_hE
rahIM_ho	0_rahA_hE
rahIM_hoMgI	0_rahA_hogA
rahIM_hoMgI	wA_rahA_hogA
rahIM_hoogI	0_rahA_hogA
rahIM_hoogI	wA_rahA_hogA
rahIM_ho	wA_rahA_hE
rahIM_ho	wA_rahA_ho
rahIM	wA_rahA
rahIM_WIM	0_rahA_WA
rahIM_WIM	wA_rahA_WA
rahI	wA_rahA
rahI_WI	0_rahA_WA
rahI_WI	wA_rahA_WA
rahoge	wA_rahegA
rahogI	wA_rahegA
rahUfgA	wA_rahUzgA
rahUfgI	wA_rahUzgA
rahUzgA	wA_rahegA
rahUzgI	wA_rahegA
sakA	0_sakA
sakawA	0_sakawA
sakawA_hE	0_sakawA_hE
sakawA_hUz	0_sakawA_hE
sakawA_WA	0_sakawA_WA
sakawe	0_sakawA
sakawe_hEM	0_sakawA_hE
sakawe_ho	0_sakawA_hE
sakawe_We	0_sakawA_WA
sakawI	0_sakawA
sakawI_hE	0_sakawA_hE
sakawI_hUz	0_sakawA_hE
sakawIM	0_sakawA
sakawIM_hEM	0_sakawA_hE
sakawIM_ho	0_sakawA_hE
sakawIM_WIM	0_sakawA_WA
sakawI_WI	0_sakawA_WA
sake	0_sakA
sakI	0_sakA
sakIM	0_sakA
se	ne_se
vAlA_hE	nA_vAlA_hE
vAlA_hE	ne_vAlA_hE
vAlA_hUz	nA_vAlA_hE
vAlA_WA	ne_vAlA_WA
vAle_hEM	nA_vAlA_hE
vAle_ho	nA_vAlA_hE
vAlI_hEM	nA_vAlA_hE
vAlI_ho	nA_vAlA_hE
vAlI_huZ	nA_vAlA_hE
vAlII_hE	nA_vAlA_hE
wA_hUz_mEM_lAie	wA_hUz_mEM_lAie
wA_rahanA_cAhie_WA	wA_rahanA_cAhie_WA
wA_rahawA_hE	wA_rahawA_hE
wA_rahawA_hUM	wA_rahawA_hE
WA	wA_WA
WA	yA_WA
we_rahawe_hEM	wA_rahawA_hE
we_rahawe_ho	wA_rahawA_hE
we_samaya	we_samaya
We	wA_WA
We	yA_WA
WIM	yA_WA
wI_rahawI_hEM	wA_rahawA_hE
wI_rahawI_hE	wA_rahawA_hE
wI_rahawI_ho	wA_rahawA_hE
wI_rahawI_hUM	wA_rahawA_hE
WI	wA_WA
WI	WI
WI	yA_WA
xiyA_jAye	ne_xiyA_jAye
xo	ne_xo
yA_cAhie_WA	yA_cAhie_WA
yA_hI_jAnA_hE	yA_hI_jAnA_hE
yA_hI_WA	yA_hI_WA
yA_huA_hogA	yA_huA_hogA
yA_huA_nahIM_hogA	yA_huA_nahIM_hogA
yA_jA_rahA_hogA	yA_jA_rahA_hogA
yA_jA_rahA	yA_jA_rahA
yA_jA_sake	yA_jA_sake
ye_binA	ye_binA
