usa_jagaha	vahAz/usa_jagaha
SiRtAcArahInawaH	asaByawaH/aSiRtawaH/SiRtAcArahInawaH
nyUnAXika	kamobeSa/kamabeSa/nyUnAXika
besAKwA	Jatapata/catapata/PatAPata/wuranwa/wuranwa/wawkAla/avilamba/avilamba/POrana/POrana/KatAka_se/wawkRaNa/wadAka_se/wada_se/wapAka_se/awiSIGra/awiSIGrawaH/jalxa_se_jalxa/jalxI_se_jalxI/wada_se/hAWoM-hAWa/hAWoM_hAWa/hAWo-hAWa/hAWo_hAWa/Kata_se/Anana-PAnana_meM/AnanaPAnana_meM/siwAba/siwAbI/besAKwA/TahAkA/ikahAI/ikahAU
kRaNa-kRaNa	prawikRaNa/pala_pala/pala-pala/prawipala/hara_kRaNa/kRaNa-kRaNa/haraGadI/hara_GadI/prawi_kRaNa/kRaNakRaNa/anukRaNa/CinaCina/Cina-Cina/AKana
bAxahavAI	vyarWa/PajUla/PijUla/PijUla/anerA/yoM_hI/vqWA/apArWa/bAxa-havAI/bAxahavAI/ahewu/ahewuka/aviraWA
Wara-Wara	Wara-Wara/WaraWara
samBAlakara	sAvaXAnIpUrvaka/XyAnapUrvaka/XyAna_se/sAvaXAnI_se/sAvaXAnawaH/samBAlakara/samBAlakara
nissanxeha	niHsanxeha/nissanxeha/jarUra/jarUra/niHsanxeha/nissanxeha/nisanxeha/nisanxeha/binA_Saka/beSaka/bilkula/bilakula/yakInana/yakInana/avaSyameva/avaSya/alabawwA/bilASaka/aBarama/vASiMxA/bASiMxA/avasi/aviwarkika/asaMSaya/niSciwawaH/ikafka
gupwawaH	gupwawaH/gupacupa_rUpa_se/corI_Cipe
Agala	sAmane/Age/samakRa/sammuKa/agre/anvakRa/aBimuKa/xarapeSa/Agala/AgalA
IrRyAhInawaH	IrRyAhInawaH/anasUyawaH/xveRahInawaH
BOMcakkA	hakkA-bakkA/BOMcakkA/kiMkarwavya-vimUDa/kiMkarwwavya-vimUDa/kiMkarwavyavimUDa/kiMkarwwavyavimUDa/hawabuxXi
labAlaba	labAlaba/labareja/labareja
wadake	sabere/savere/subaha/wadake/subaha-subaha/subaha_savere
hara_GadI	prawikRaNa/pala_pala/pala-pala/prawipala/hara_kRaNa/kRaNa-kRaNa/haraGadI/hara_GadI/prawi_kRaNa/kRaNakRaNa/anukRaNa/CinaCina/Cina-Cina/AKana
cAranAcAra	majabUrana/vivaSawaH/anacAhe/majabUrana/vivaSa_hokara/cAranAcAra/anwawogawvA/barabasa
Barasaka	yaWASakwi/Barasaka/yaWAsAXya/yaWAsamBava/kRamawAnusAra/yaWAkRama
AgalA	sAmane/Age/samakRa/sammuKa/agre/anvakRa/aBimuKa/xarapeSa/Agala/AgalA
anavarawa	lagAwAra/anavarawa/niranwara/niranwara/wAbadawoda/xanAxana/sawawa/XUAzXAra/ananwara/ananwara/avirAmawaH/aniSa/prawikRaNa/anukRaNa/XadAXada/avirawa/muwwasila/avicCinna/avicCexa/aviSrAnwa/aviSrAnwa/asarAra/aharaha/Asafga/Asafga/ikawAra
kaI_bAra	kaI_bAra/bahuwa_bAra/anekaSaH
AKirakAra	anwawaH/anwawogawvA/anwa_meM/AKira/AKira/AKirakAra/AKirakAra/howe_havAwe
gaharAI_meM	gahare/gaharAI_meM
kramahInawaH	kramahInawaH/akramawaH/avyavasWiwawaH/jahAz_wahAz
ajo	aba_waka/aBI_waka/Aja_waka/abawaka/aBIwaka/Ajawaka/ajahuz/ajahUz/ajo/ajOM/abalaga
AxeSAnusAra	AjFAnusAra/AxeSAnusAra
vApisa	vApasa/vApisa
anXAXunXa	anXAXunXa/bewahASA/anXAXunXa/anXaXunXa/anXaXunXa/utakkara
yaWABIRta	icCAnusAra/icCAnukula/yaWecCa/yaWABIRta/yaWAvAFCiwa
saba_milAkara	kula_milAkara/saba_milAkara
aXika	Upara/aXika/jyAxA/jyAxA/bahuwa/KUba/KUba/badA/jyAxA/jyAxA/aXika/kAPI/kAPI/kadA/jamakara/datakara
pahale-pahala	pahale_pahala/praWamawaH/sarva_praWama/sarvapraWama/SurU_meM/pahale-pahala/avvalana/pahile_pahala/pahile_pahala
pata	pata/patta/petakEyAz
cupake-cupake	cupake_se/cupake-cupake/xaraparaxA
pUrexina	xinaBara/pUrexina
raPwA-raPwA	XIre-XIre/XIre_XIre/Ahiswe-Ahiswe/AhiswA-AhiswA/hOle-hOle/hole-hole/raPwA-raPwA/alpaSaH
Asa-pAsa	pAsa_meM/najaxIka/najaxIka/nikata_meM/karIba_meM/samIpa/nikata/pAsa/karIba/karIba/sannikata/najIka/muwwasila/arvAka/avixUra/Are/AsapAsa/Asa-pAsa/Asa-pAsa/AsapAsa/agala-bagala/agala-bagala/AjU-bAjU/irxa-girxa/adosa-padosa/pAsa-padosa/pAsa_padosa
kadAI_se	nirxayawApUrvaka/nirxayawA_se/berahamI_se/bexarxI_se/krUrawApUrvaka/barbarawApUrvaka/kaTorawA_se/kadAI_se
meM	ke_anxara/ke_anxara/ke_BIwara/meM
pUrvawaH	pahale_se/pUrvawaH/pahale_se_hI
agala-bagala	Asa-pAsa/AsapAsa/agala-bagala/agala-bagala/AjU-bAjU/irxa-girxa/adosa-padosa/pAsa-padosa/pAsa_padosa
pariNAmasvarUpa	PalasvarUpa/pariNAma_svarUpa/pariNAmasvarUpa/pariNAmawaH/PalawaH/nawIjawana
mAzgakara	mAzgakara/yAciwawaH
niwa	prawixina/haraxina/niwya/hararoja/roja/niwa/roja/rojAnA/rojAnA/anuxina/niwyaprawi/anuxivasa/aharaha
Dafga_se	viXipUrvaka/kAyaxe_se/Dafga_se/warIke_se/bawOra/bAkAyaxA/viXivaw/viXivawa
TaNDe_TaNDe	TaNde-TaNde/TaNde_TaNde/TaNDe-TaNDe/TaNDe_TaNDe
bAxa	bAxa/bAxa_meM/paScAw/uparAnwa/ananwara/paScAwa/uparAnwa/ananwara/pICe/uwwara/aWa/anupaxa/anvakRa/pare/Age/bAxa
pahile_pahala	pahale_pahala/praWamawaH/sarva_praWama/sarvapraWama/SurU_meM/pahale-pahala/avvalana/pahile_pahala/pahile_pahala/pahale_pahala/praWamawaH/sarva_praWama/sarvapraWama/SurU_meM/pahale-pahala/avvalana/pahile_pahala/pahile_pahala
xanAxana	lagAwAra/anavarawa/niranwara/niranwara/wAbadawoda/xanAxana/sawawa/XUAzXAra/ananwara/ananwara/avirAmawaH/aniSa/prawikRaNa/anukRaNa/XadAXada/avirawa/muwwasila/avicCinna/avicCexa/aviSrAnwa/aviSrAnwa/asarAra/aharaha/Asafga/Asafga/ikawAra/xanAxana
BIwara	anxara/anxara/BIwara/anxara/anxara/BIwara
saxEva	hameSA/saxA/niwya/saxEva/niwya_prawi/sarvaxA/sarvaWA/haraxama/haravakwa/harasamaya/xina-rAwa/xinarAwa/xina_rAwa/rAwa-xina/rAwaxina/niSixina/nisa-vAsara/nisavAsara/niSivAsara/niranwara/niranwara/anavaXi/sarvaxEva/aharaha/pinnA/aharniSa/ahorAwra
aparAXAnusAra	yaWAparAXa/aparAXAnusAra
apArWa	vyarWa/PajUla/PijUla/PijUla/anerA/yoM_hI/vqWA/apArWa/bAxa-havAI/bAxahavAI/ahewu/ahewuka/aviraWA
ke_anxara	ke_anxara/ke_anxara/ke_BIwara/meM
sAWa	sAWa-sAWa/sAWa_hI/sAWa_hI_sAWa/sAWa/eka_sAWa/ikatTA/ikajora/ekawra/ikawra
sahajawA_se	AsAnI_se/sahajawA_se/saralawA_se/Kela_Kela_meM/sahajawaH/anEse
wejI_se	kasakara/joraxAra/weja/weja/wIvra/wejI_se/jora_se/wejI_se/jora_se/wIvrawA_se
labareja	labAlaba/labareja/labareja
AKirakAra	anwawaH/anwawogawvA/anwa_meM/AKira/AKira/AKirakAra/AKirakAra/howe_havAwe
ekafga	akelA/akele/kevala/sirPa/mAwra/KAlI/KAlI/basa/nipata/mahaja/sirPa/wanhA/wanahA/ekAkI/ekameva/ekafga/ikelA
rAwoM-rAwa	rAwoM-rAwa/rAwoMrAwa
SiRtawaH	SiRtawaH/saByawaH/bAsaUra/SAlInawaH/SiRtAcArapUrvaka/salIke_se
AjFApUrvaka	AjFApUrvaka/AxeSapUrvaka/sAxeSa/AxeSa_se
jabarana	balapUrvaka/barabasa/jabaraxaswI/jabaraxaswI/jabarana/jabarana/barajorI
niwAnwa	bilkula/bilakula/ekaxama/nipata/sarAsara/TIka/niwAnwa/niwAnwa/pUrNawaH/pUrI_waraha_se/pUrNawayA/sampUrNawaH/sampUrNawayA/pUrNarupeNa/AmUlacUla/Sawa-prawiSawa
sABAra	sABAra/kqwajFawApUrvaka
yaWeRta	paryApwa/kAPI/kAPI/yaWeRta/alam/alaM
bArambAra	bAra-bAra/bAra_bAra/bArambAra/bArambAra/asakqwa/ahora-bahora
PUta-PUtakara	PUta-PUtakara/PUtaPUta_kara
savere	sabere/savere/subaha/wadake/subaha-subaha/subaha_savere/jalxI/savere/sabere
yaWAvAFCiwa	icCAnusAra/icCAnukula/yaWecCa/yaWABIRta/yaWAvAFCiwa
akelA	akelA/akele/kevala/sirPa/mAwra/KAlI/KAlI/basa/nipata/mahaja/sirPa/wanhA/wanahA/ekAkI/ekameva/ekafga/ikelA
karIbana	anxAjana/anxAjana/anxAjana/anxAjana/lagaBaga/wakarIbana/wakarIbana/karIba/karIba/karIbakarIba/karIbana/karIbakarIba/karIbana/anumAnawaH/anakarIba/anakarIba/waKamInana/anxAja_se/ukavAz
iXara	iXara/isa_ora/yahAz_para/iwaH/iwa/iwE/iwWe
bA-jAbwA	niyamAnusAra/yaWAniyama/bA-jAbwA
kAlha	kala/kAlha
mara-marakara	awyaXika_prayawnapUrvaka/mara-marakara
cAroM_waraPa	cAroM_ora/cAroM_waraPa/cAroM_waraPa/cahuz_ora/sarvawra/saBI_waraPa/cAroM_xiSAoM_meM/hara_jagaha/irxa-girxa
baga-mela	bagamela/baga-mela
pravAha_kI_xiSA_meM	pravAha_kI_xiSA_meM/pravAha_kI_ora
samaya-samaya_para	samaya-samaya_para/bIca-bIca_meM
akele	akelA/akele/kevala/sirPa/mAwra/KAlI/KAlI/basa/nipata/mahaja/sirPa/wanhA/wanahA/ekAkI/ekameva/ekafga/ikelA
jiMxagIBara	mqwyuparyanwa/AjIvana/wAumra/umraBara/jiMxagIBara/jiMxagIBara/jIvanaBara/AmaraNa/anwima_xama_waka
sAWa_hI	sAWa-sAWa/sAWa_hI/sAWa_hI_sAWa/sAWa/eka_sAWa/ikatTA/ikajora/ekawra/ikawra
xviguNiwa	xugunA/xUnA/xogunA/xuganA/xviguNa/xviguNiwa
XyAnapUrvaka	sAvaXAnIpUrvaka/XyAnapUrvaka/XyAna_se/sAvaXAnI_se/sAvaXAnawaH/samBAlakara/samBAlakara
viSvasanIyawA_se	viSvAsa_ke_sAWa/viSvasanIyawA_se/viSvAsapUrvaka
yOM_hI	vyarWa_hI/yoM_hI/JUTa-mUTa/yOM_hI/yUz_hI/Ese_hI/nAhaka/nAhaka/PajUla/PajUla/PijUla/PijUla/anahaka/anAhaka
xina-xina	xina-prawixina/xina-xina/xina-para-xina/xina-baxina/xina-ba_xina/xinaprawixina/xinaxina/xinabaxina/xinoM-xina/xinoMxina
mOnawaH	cupacApa/cupa/mOna/SAnwa/SAnwa/KAmoSI_se/KAmoSI_se/niSSabxa/avAka/avAk/bina_bole/mOnawaH
aviSrAnwa	lagAwAra/anavarawa/niranwara/niranwara/wAbadawoda/xanAxana/sawawa/XUAzXAra/ananwara/ananwara/avirAmawaH/aniSa/prawikRaNa/anukRaNa/XadAXada/avirawa/muwwasila/avicCinna/avicCexa/aviSrAnwa/aviSrAnwa/asarAra/aharaha/Asafga/Asafga/ikawAra
BaviRya_meM	BaviRya_meM/Age/BaviRya_kAla_meM/agawyA
ukadUz	ukadUz/ukadU/ukadUz/ukadU/ukurU
kuSalapUrvaka	sakuSala/kuSalawApUrvaka/kuSalapUrvaka/sahI_salAmawa/sahI-salAmawa/TIka-TAka/TIka_se/TIka-TAka_se/TIkaTAka/baKEra/baKEra/baKErIya/baKErIyawa/surakRiwawaH
warawIba_se	warIke_se/warIke_se/warawIba_se/karIne_se/karIne_se/vyavasWApUrvaka/vyavasWiwawaH/karInAvAra/karInAvAra
kula_milAkara	kula_milAkara/saba_milAkara
anwima_xama_waka	mqwyuparyanwa/AjIvana/wAumra/umraBara/jiMxagIBara/jiMxagIBara/jIvanaBara/AmaraNa/anwima_xama_waka
jaba	jaba/yaxA/yaxi/agara/jaba
Bara_meM	Bara_meM
ima	yoM/yUz/Ese/isa_waraha/isa_prakAra/EsA/iwWaM/ima/imi/iBa/iva/isE/IxqS/IxqSa
imi	yoM/yUz/Ese/isa_waraha/isa_prakAra/EsA/iwWaM/ima/imi/iBa/iva/isE/IxqS/IxqSa
saKwa	awyanwa/awyanwa/awyaXika/be-iMwahA/beiMwahA/bahuwa_aXika/bahuwa_hI/bepanAha/saKwa/saKwa/jamakara/mahA/nihAyawa/cUdAnwa/cUdAnwa/aByaXika/Agara
jora-Sora_se	jora-Sora_se/jora-Sora_se/joraSora_se/joraSora_se/joroM_se/joroM_se
anwarjAnu	anwarjAnu/anwarjAnu
umUmana	sAmAnyawaH/sAmAnyawayA/sAXAraNawaH/sAXAraNawayA/amUmana/umUmana
hameSA	hameSA/saxA/niwya/saxEva/niwya_prawi/sarvaxA/sarvaWA/haraxama/haravakwa/harasamaya/xina-rAwa/xinarAwa/xina_rAwa/rAwa-xina/rAwaxina/niSixina/nisa-vAsara/nisavAsara/niSivAsara/niranwara/niranwara/anavaXi/sarvaxEva/aharaha/pinnA/aharniSa/ahorAwra
viSeRawaH	viSeRakara/KAsakara/KAsa_wOra_para/KAsa_wOra_se/KAsawOra_para/KAsawOra_se/KAsawOra_para/KAsawOra_se/KAsakara/viSeRawaH/viSiRtawaH/muKyawaH/viSeRa_rUpa_se
AramBawaH	AramBa_meM/AramBawaH/AramBawaH/pahale/SurU_meM/praWama/Axi_meM/praWamawaH/sarvapraWama/pUrva/SuruAwa_meM/SuruvAwa_meM/AramBa_meM/prAramBa_meM
IsavI_pUrva	IsApUrva/IsA_pUrva/IsavI_pUrva
kiMkarwwavyavimUDa	hakkA-bakkA/BOMcakkA/kiMkarwavya-vimUDa/kiMkarwwavya-vimUDa/kiMkarwavyavimUDa/kiMkarwwavyavimUDa/hawabuxXi
anxara	anxara/anxara/BIwara/anxara/anxara/BIwara
ihavEM	yahIM/isI_jagaha/ihavEM
Ocaka	acAnaka/ekAeka/sahasA/ekabAragI/ikabAragI/yakAyaka/akasmAwa/akasmAw/anAyAsa/xEvAw/xEvavaSa/Ocaka/aprawyASiwawaH/ApAwawaH/aFcakEM/agawyA/acaka/acAFcaka/acAkA/acAka/acAna/anAgawaH/anyAsa/nAgahAz/AcAna/ikahAI/ikahAU/iwwiPAkana/iwwiPAkana/iwwaPAkana/iwwaPAkana/ucakA/Ocaka/acAnaka/ekAeka/sahasA/ekabAragI/ikabAragI/yakAyaka/akasmAwa/akasmAw/anAyAsa/xEvAw/xEvavaSa/Ocaka/aprawyASiwawaH/ApAwawaH/aFcakEM/agawyA/acaka/acAFcaka/acAkA/acAka/acAna/anAgawaH/anyAsa/nAgahAz/AcAna/ikahAI/ikahAU/iwwiPAkana/iwwiPAkana/iwwaPAkana/iwwaPAkana/ucakA/Ocaka
yaWecCa	icCAnusAra/icCAnukula/yaWecCa/yaWABIRta/yaWAvAFCiwa
niyamiwawaH	niyamiwawaH/niyama_se/niyamAnusAra/baxaswUra
kusamaya	kusamaya/galawa_vakwa_para/asamaya/bevakwa/galawa_vakwa_para/bevakwa/bemOke
PurwI_se	sPUrwipUrvaka/cuswI_se/PurwI_se/muswExI_se
upAyawaH	yukwipUrvaka/upAyawaH/upAya_se/jugawa_lagAkara/warakIba_se/warIke_se
iwWaM	yoM/yUz/Ese/isa_waraha/isa_prakAra/EsA/iwWaM/ima/imi/iBa/iva/isE/IxqS/IxqSa
avirAmawaH	lagAwAra/anavarawa/niranwara/niranwara/wAbadawoda/xanAxana/sawawa/XUAzXAra/ananwara/ananwara/avirAmawaH/aniSa/prawikRaNa/anukRaNa/XadAXada/avirawa/muwwasila/avicCinna/avicCexa/aviSrAnwa/aviSrAnwa/asarAra/aharaha/Asafga/Asafga/ikawAra
bIca-bIca_meM	samaya-samaya_para/bIca-bIca_meM
jIvanaparyanwa	Ajanma/jIvanaparyanwa/jIvanaBara
ATagunA	ATagunA/aTagunA
icCA_se	svecCApUrvaka/icCA_se/KuSI_KuSI/KuSI_se/svecCayA/svecCawaH
cahuz_ora	cAroM_ora/cAroM_waraPa/cAroM_waraPa/cahuz_ora/sarvawra/saBI_waraPa/cAroM_xiSAoM_meM/hara_jagaha/irxa-girxa
bAkAyaxA	viXipUrvaka/kAyaxe_se/Dafga_se/warIke_se/bawOra/bAkAyaxA/viXivaw/viXivawa
PalasvarUpa	PalasvarUpa/pariNAma_svarUpa/pariNAmasvarUpa/pariNAmawaH/PalawaH/nawIjawana
niyamAnusAra	niyamiwawaH/niyama_se/niyamAnusAra/baxaswUra/niyamAnusAra/yaWAniyama/bA-jAbwA
sABiprAyaH	uxxeSyapUrvaka/uxxeSyawaH/sABiprAyaH/soxxeSya
sanxigXawaH	aspaRtawaH/sanxigXawaH
wAbadawoda	lagAwAra/anavarawa/niranwara/niranwara/wAbadawoda/xanAxana/sawawa/XUAzXAra/ananwara/ananwara/avirAmawaH/aniSa/prawikRaNa/anukRaNa/XadAXada/avirawa/muwwasila/avicCinna/avicCexa/aviSrAnwa/aviSrAnwa/asarAra/aharaha/Asafga/Asafga/ikawAra
wIvra	kasakara/joraxAra/weja/weja/wIvra/wejI_se/jora_se/wejI_se/jora_se/wIvrawA_se
yukwipUrvaka	yukwipUrvaka/upAyawaH/upAya_se/jugawa_lagAkara/warakIba_se/warIke_se
aBI-aBI	aBI-aBI/aBI_aBI/aBI_hI/isI_vakwa/isI_kRaNa
Aswe	XIre/XIme/hOle/Ahiswe/AhiswA/Ahiswe_se/AhiswA_se/Asawe/Aswe
jora_se	kasakara/joraxAra/weja/weja/wIvra/wejI_se/jora_se/wejI_se/jora_se/wIvrawA_se
avaSyameva	niHsanxeha/nissanxeha/jarUra/jarUra/niHsanxeha/nissanxeha/nisanxeha/nisanxeha/binA_Saka/beSaka/bilkula/bilakula/yakInana/yakInana/avaSyameva/avaSya/alabawwA/bilASaka/aBarama/vASiMxA/bASiMxA/avasi/aviwarkika/asaMSaya/niSciwawaH/ikafka
isE	yoM/yUz/Ese/isa_waraha/isa_prakAra/EsA/iwWaM/ima/imi/iBa/iva/isE/IxqS/IxqSa
navagunA	nOgunA/navagunA
BalI_BAzwi	BalI-BAzwi/BalI_BAzwi/BarapUra/BalIBAzwi/BalI-BAnwi/BalI_BAnwi/BalIBAnwi/sarvawoBAva/acCI_waraha
bAez_bAjU	bAez/bAez_bAjU/bAyeM
akramawaH	kramahInawaH/akramawaH/avyavasWiwawaH/jahAz_wahAz
bilAnAgA	bilAnAgA
avixUra	pAsa_meM/najaxIka/najaxIka/nikata_meM/karIba_meM/samIpa/nikata/pAsa/karIba/karIba/sannikata/najIka/muwwasila/arvAka/avixUra/Are/AsapAsa/Asa-pAsa
haragija	kaxApi/haragija/kawaI/kawwaI
nirnimeKa	apalaka/nirnimeRa/nirnimiRa/nirnimeKa
saralawA_se	AsAnI_se/sahajawA_se/saralawA_se/Kela_Kela_meM/sahajawaH/anEse
alabawwA	niHsanxeha/nissanxeha/jarUra/jarUra/niHsanxeha/nissanxeha/nisanxeha/nisanxeha/binA_Saka/beSaka/bilkula/bilakula/yakInana/yakInana/avaSyameva/avaSya/alabawwA/bilASaka/aBarama/vASiMxA/bASiMxA/avasi/aviwarkika/asaMSaya/niSciwawaH/ikafka
rojAnA	prawixina/haraxina/niwya/hararoja/roja/niwa/roja/rojAnA/rojAnA/anuxina/niwyaprawi/anuxivasa/aharaha
paramparAnusAra	paramparAnusAra/baxaswUra
niHsafkoca	nisafkoca/niHsafkoca/nissafkoca/beXadaka/safkocahInawaH/beJiJaka/beKataka/beKatake/behicaka
uxAharaNArWa	uxAharaNArWa/uxAharaNawaH/uxAharaNa_svarUpa/masalana
agre	sAmane/Age/samakRa/sammuKa/agre/anvakRa/aBimuKa/xarapeSa/Agala/AgalA
jEse_BI_ho	jEse_ho/jEse_BI_ho
iwane_meM	iwane_meM/isa_bIca/isI_bIca/isa_xOrAna/isa_xaramyAna
pExala	pExala
kqpA_karake	kqpayA/kqpApUrvaka/kqpA_pUrvaka/kqpA_karake/meharabAnI_karake
muKyawaH	viSeRakara/KAsakara/KAsa_wOra_para/KAsa_wOra_se/KAsawOra_para/KAsawOra_se/KAsawOra_para/KAsawOra_se/KAsakara/viSeRawaH/viSiRtawaH/muKyawaH/viSeRa_rUpa_se
acCA	TIka-TAka/TIkaTAka/TIka/acCA/baDiyA/acCA/baDiyA/acCI_waraha/acCI_waraha_se/tanAtana
webArA	wibArA/webArA
kaBI	kaBI/kisI_samaya
irAxawana	safkalpapUrvaka/irAxawana/irAxe_se/xqDawApUrvaka/niScayapUrvaka/jAna-bUJakara/jAnabUJakara/jAnabUJa_kara/amaxana/icCApUrvaka/mawipUrva/irAxawana
rawwiBara	jarA/jarA/jarA-sA/jarA-sA/rawwiBara/WodA/WodA-sA/WodA_sA/wanika/yawkiMciw
majabUwI_se	xqDawApUrvaka/majabUwI_se/majabUwI_se
mawipUrva	jAna-bUJakara/jAnabUJakara/jAnabUJa_kara/amaxana/icCApUrvaka/mawipUrva/irAxawana
nirxayawA_se	nirxayawApUrvaka/nirxayawA_se/berahamI_se/bexarxI_se/krUrawApUrvaka/barbarawApUrvaka/kaTorawA_se/kadAI_se
pacagunA	pAzcagunA/pacagunA
hOle	XIre/XIme/hOle/Ahiswe/AhiswA/Ahiswe_se/AhiswA_se/Asawe/Aswe
apekRayA	apekRAkqwa/wulanA_meM/apekRayA/mukAbale/mukAbale/banisbawa/se
vicArapUrvaka	soca-vicArakara/samaJa-bUJakara/vicArapUrvaka/soca-samaJakara/soca_vicAra_kara/samaJa_bUJa_kara/soca_samaJa_kara/vicAriwawaH
nAKuSI_se	aprasannawApUrvaka/nArAjagIpUrvaka/nAKuSI_se/nArAjagIpUrvaka/nAKuSI_se
AsO	aso/asoM/AsO/isa_varRa/isa_sAla
sampUrNawaH	bilkula/bilakula/ekaxama/nipata/sarAsara/TIka/niwAnwa/niwAnwa/pUrNawaH/pUrI_waraha_se/pUrNawayA/sampUrNawaH/sampUrNawayA/pUrNarupeNa/AmUlacUla/Sawa-prawiSawa
kaba_waka	kaba_waka/kaba
pAsa-padosa	Asa-pAsa/AsapAsa/agala-bagala/agala-bagala/AjU-bAjU/irxa-girxa/adosa-padosa/pAsa-padosa/pAsa_padosa
svawanwra_rUpa_se	svAXInawaH/svawanwra_rUpa_se
havA_kI_ora	havA_ke_anukUla/havAnukUla/havA_kI_ora/havA_kI_waraPa
xina-ba_xina	xina-prawixina/xina-xina/xina-para-xina/xina-baxina/xina-ba_xina/xinaprawixina/xinaxina/xinabaxina/xinoM-xina/xinoMxina
ciMwAhInawaH	niSciMwawaH/ciMwAhInawaH/beKatake
Jatake_ke_sAWa	Jatake_se/Jatake_ke_sAWa
tukura_tukura	takatakI_se/ekataka/tukura_tukura/taka-taka/animeRa/animiRa/animiKa/anamiKa/ikataka
havAnukUla	havA_ke_anukUla/havAnukUla/havA_kI_ora/havA_kI_waraPa
anuxivasa	prawixina/haraxina/niwya/hararoja/roja/niwa/roja/rojAnA/rojAnA/anuxina/niwyaprawi/anuxivasa/aharaha
vinayapUrvaka	namrawApUrvaka/vinayapUrvaka
Ahiswe-Ahiswe	XIre-XIre/XIre_XIre/Ahiswe-Ahiswe/AhiswA-AhiswA/hOle-hOle/hole-hole/raPwA-raPwA/alpaSaH
paraseMta	prawiSawa/PIsaxI/PIsaxI/paraseMta
aXorXa	Upara-nIce/aXoraXa/aXorXa/aXOrxXa
saccI_muccI	vAkaI/vAkaI/vAswava_meM/hakIkawana/hakIkawana/xaraasala/asala_meM/sacamuca/saccI-muccI/saccI_muccI/sawyawaH/vaswuwaH
baKErIyawa	sakuSala/kuSalawApUrvaka/kuSalapUrvaka/sahI_salAmawa/sahI-salAmawa/TIka-TAka/TIka_se/TIka-TAka_se/TIkaTAka/baKEra/baKEra/baKErIya/baKErIyawa/surakRiwawaH
saca-saca	saca-saca
kaBI_nahIM	kaBI_nahIM
sAWa_hI_sAWa	sAWa-sAWa/sAWa_hI/sAWa_hI_sAWa/sAWa/eka_sAWa/ikatTA/ikajora/ekawra/ikawra
anumAnawaH	anxAjana/anxAjana/anxAjana/anxAjana/lagaBaga/wakarIbana/wakarIbana/karIba/karIba/karIbakarIba/karIbana/karIbakarIba/karIbana/anumAnawaH/anakarIba/anakarIba/waKamInana/anxAja_se/ukavAz
pAsa_padosa	Asa-pAsa/AsapAsa/agala-bagala/agala-bagala/AjU-bAjU/irxa-girxa/adosa-padosa/pAsa-padosa/pAsa_padosa
svagawa	svagawa
bevakwa	kusamaya/galawa_vakwa_para/asamaya/bevakwa/galawa_vakwa_para/bevakwa/bemOke/asamaya/bevakwa/bevakwa/galawa_samaya_para/galawa_samaya_para/bemOke
POrana	Jatapata/catapata/PatAPata/wuranwa/wuranwa/wawkAla/avilamba/avilamba/POrana/POrana/KatAka_se/wawkRaNa/wadAka_se/wada_se/wapAka_se/awiSIGra/awiSIGrawaH/jalxa_se_jalxa/jalxI_se_jalxI/wada_se/hAWoM-hAWa/hAWoM_hAWa/hAWo-hAWa/hAWo_hAWa/Kata_se/Anana-PAnana_meM/AnanaPAnana_meM/siwAba/siwAbI/besAKwA/TahAkA/ikahAI/ikahAU
bahuwa_hI	awyanwa/awyanwa/awyaXika/be-iMwahA/beiMwahA/bahuwa_aXika/bahuwa_hI/bepanAha/saKwa/saKwa/jamakara/mahA/nihAyawa/cUdAnwa/cUdAnwa/aByaXika/Agara
saByawaH	SiRtawaH/saByawaH/bAsaUra/SAlInawaH/SiRtAcArapUrvaka/salIke_se
ulatA-palatA	ulatA-pulatA/ulatA_pulatA/ulatA-palatA/ultA-paltA/ultA-pultA/ultA_pultA
avera-savera	xera-savera/avera-savera
Ajakala	PilahAla/PilahAla/aba/varwamAna_meM/Aja-kala/Ajakala/Aja_kala/AjakAla/ina_xinoM/isa_samaya/samprawi
saccI-muccI	vAkaI/vAkaI/vAswava_meM/hakIkawana/hakIkawana/xaraasala/asala_meM/sacamuca/saccI-muccI/saccI_muccI/sawyawaH/vaswuwaH
aWa	bAxa/bAxa_meM/paScAw/uparAnwa/ananwara/paScAwa/uparAnwa/ananwara/pICe/uwwara/aWa/anupaxa/anvakRa/aBI/PilahAla/PilahAla/isa_samaya/aba/aWa/aXunA/samprawi/samprawi/aBU/aBE
avaSya	niHsanxeha/nissanxeha/jarUra/jarUra/niHsanxeha/nissanxeha/nisanxeha/nisanxeha/binA_Saka/beSaka/bilkula/bilakula/yakInana/yakInana/avaSyameva/avaSya/alabawwA/bilASaka/aBarama/vASiMxA/bASiMxA/avasi/aviwarkika/asaMSaya/niSciwawaH/ikafka/avaSya/jarUra/jarUra
jugawa_lagAkara	yukwipUrvaka/upAyawaH/upAya_se/jugawa_lagAkara/warakIba_se/warIke_se
ultA_pultA	ulatA-pulatA/ulatA_pulatA/ulatA-palatA/ultA-paltA/ultA-pultA/ultA_pultA
xogunA	xugunA/xUnA/xogunA/xuganA/xviguNa/xviguNiwa
subaha	sabere/savere/subaha/wadake/subaha-subaha/subaha_savere
haraxama	hameSA/saxA/niwya/saxEva/niwya_prawi/sarvaxA/sarvaWA/haraxama/haravakwa/harasamaya/xina-rAwa/xinarAwa/xina_rAwa/rAwa-xina/rAwaxina/niSixina/nisa-vAsara/nisavAsara/niSivAsara/niranwara/niranwara/anavaXi/sarvaxEva/aharaha/pinnA/aharniSa/ahorAwra
awaH	isalie/isIlie/awaeva/awaH/lihAjA/lihAjA
jAnabUJa_kara	jAna-bUJakara/jAnabUJakara/jAnabUJa_kara/amaxana/icCApUrvaka/mawipUrva/irAxawana
wakarIbana	anxAjana/anxAjana/anxAjana/anxAjana/lagaBaga/wakarIbana/wakarIbana/karIba/karIba/karIbakarIba/karIbana/karIbakarIba/karIbana/anumAnawaH/anakarIba/anakarIba/waKamInana/anxAja_se/ukavAz
nikata_meM	pAsa_meM/najaxIka/najaxIka/nikata_meM/karIba_meM/samIpa/nikata/pAsa/karIba/karIba/sannikata/najIka/muwwasila/arvAka/avixUra/Are/AsapAsa/Asa-pAsa
hole-hole	XIre-XIre/XIre_XIre/Ahiswe-Ahiswe/AhiswA-AhiswA/hOle-hOle/hole-hole/raPwA-raPwA/alpaSaH
paxa_prawi_paxa	kaxama_ba_kaxama/eka_eka_daga/paxa_prawi_paxa
asamaya	kusamaya/galawa_vakwa_para/asamaya/bevakwa/galawa_vakwa_para/bevakwa/bemOke/asamaya/bevakwa/bevakwa/galawa_samaya_para/galawa_samaya_para/bemOke
jyAxA	Upara/aXika/jyAxA/jyAxA/bahuwa/KUba/KUba/badA/jyAxA/jyAxA/aXika/kAPI/kAPI/kadA/jamakara/datakara
cUdAnwa	awyanwa/awyanwa/awyaXika/be-iMwahA/beiMwahA/bahuwa_aXika/bahuwa_hI/bepanAha/saKwa/saKwa/jamakara/mahA/nihAyawa/cUdAnwa/cUdAnwa/aByaXika/Agara
yaWAkrama	kramaSaH/kramAnusAra/yaWAkrama/silasilevAra/bArI-bArI_se/kramavAra/warawIbavAra/ayugapaxa/alpaSaH
anuxina	prawixina/haraxina/niwya/hararoja/roja/niwa/roja/rojAnA/rojAnA/anuxina/niwyaprawi/anuxivasa/aharaha
avAk	cupacApa/cupa/mOna/SAnwa/SAnwa/KAmoSI_se/KAmoSI_se/niSSabxa/avAka/avAk/bina_bole/mOnawaH
avAka	cupacApa/cupa/mOna/SAnwa/SAnwa/KAmoSI_se/KAmoSI_se/niSSabxa/avAka/avAk/bina_bole/mOnawaH
niHsanxeha	niHsanxeha/nissanxeha/jarUra/jarUra/niHsanxeha/nissanxeha/nisanxeha/nisanxeha/binA_Saka/beSaka/bilkula/bilakula/yakInana/yakInana/avaSyameva/avaSya/alabawwA/bilASaka/aBarama/vASiMxA/bASiMxA/avasi/aviwarkika/asaMSaya/niSciwawaH/ikafka
havA_ke_anukUla	havA_ke_anukUla/havAnukUla/havA_kI_ora/havA_kI_waraPa
aXikArapUrvaka	aXikArapUrvaka/sAXikAra/aXikArawaH
iwaswawaH	iXara-uXara/jahAz-wahAz/yahAz-vahAz/iwauwa/iwaswawaH
svecCApUrvaka	svecCApUrvaka/icCA_se/KuSI_KuSI/KuSI_se/svecCayA/svecCawaH
sarvopari	sarvopari
sahI_salAmawa	sakuSala/kuSalawApUrvaka/kuSalapUrvaka/sahI_salAmawa/sahI-salAmawa/TIka-TAka/TIka_se/TIka-TAka_se/TIkaTAka/baKEra/baKEra/baKErIya/baKErIyawa/surakRiwawaH
avyavasWiwawaH	kramahInawaH/akramawaH/avyavasWiwawaH/jahAz_wahAz
paScAw	bAxa/bAxa_meM/paScAw/uparAnwa/ananwara/paScAwa/uparAnwa/ananwara/pICe/uwwara/aWa/anupaxa/anvakRa
xinaBara	xinaBara/pUrexina
ayAciwawaH	binamAzge/bina_mAzge/anamAzge/ayAciwawaH
AxyopAnwa	AxyopAnwa/AxyopAnwa/AxyAnwa/AxyAnwa
nalla	nalla/nalla/nalla/nalla/nalla/nalla/nalla/nalla
bilakula	niHsanxeha/nissanxeha/jarUra/jarUra/niHsanxeha/nissanxeha/nisanxeha/nisanxeha/binA_Saka/beSaka/bilkula/bilakula/yakInana/yakInana/avaSyameva/avaSya/alabawwA/bilASaka/aBarama/vASiMxA/bASiMxA/avasi/aviwarkika/asaMSaya/niSciwawaH/ikafka/bilkula/bilakula/ekaxama/nipata/sarAsara/TIka/niwAnwa/niwAnwa/pUrNawaH/pUrI_waraha_se/pUrNawayA/sampUrNawaH/sampUrNawayA/pUrNarupeNa/AmUlacUla/Sawa-prawiSawa
soxxeSya	uxxeSyapUrvaka/uxxeSyawaH/sABiprAyaH/soxxeSya
irAxe_se	safkalpapUrvaka/irAxawana/irAxe_se/xqDawApUrvaka/niScayapUrvaka
prayawna_se	prayawnapUrvaka/sAyAsa/prayawnawaH/prayawna_se
sAxeSa	AjFApUrvaka/AxeSapUrvaka/sAxeSa/AxeSa_se
PIsaxI	prawiSawa/PIsaxI/PIsaxI/paraseMta
yahIM	yahIM/isI_jagaha/ihavEM
hAWo-hAWa	Jatapata/catapata/PatAPata/wuranwa/wuranwa/wawkAla/avilamba/avilamba/POrana/POrana/KatAka_se/wawkRaNa/wadAka_se/wada_se/wapAka_se/awiSIGra/awiSIGrawaH/jalxa_se_jalxa/jalxI_se_jalxI/wada_se/hAWoM-hAWa/hAWoM_hAWa/hAWo-hAWa/hAWo_hAWa/Kata_se/Anana-PAnana_meM/AnanaPAnana_meM/siwAba/siwAbI/besAKwA/TahAkA/ikahAI/ikahAU
cAroM_xiSAoM_meM	cAroM_ora/cAroM_waraPa/cAroM_waraPa/cahuz_ora/sarvawra/saBI_waraPa/cAroM_xiSAoM_meM/hara_jagaha/irxa-girxa
SAnwipUrvaka	SAnwipUrvaka/SAnwipUrvaka
ikahAU	acAnaka/ekAeka/sahasA/ekabAragI/ikabAragI/yakAyaka/akasmAwa/akasmAw/anAyAsa/xEvAw/xEvavaSa/Ocaka/aprawyASiwawaH/ApAwawaH/aFcakEM/agawyA/acaka/acAFcaka/acAkA/acAka/acAna/anAgawaH/anyAsa/nAgahAz/AcAna/ikahAI/ikahAU/iwwiPAkana/iwwiPAkana/iwwaPAkana/iwwaPAkana/ucakA/Ocaka/Jatapata/catapata/PatAPata/wuranwa/wuranwa/wawkAla/avilamba/avilamba/POrana/POrana/KatAka_se/wawkRaNa/wadAka_se/wada_se/wapAka_se/awiSIGra/awiSIGrawaH/jalxa_se_jalxa/jalxI_se_jalxI/wada_se/hAWoM-hAWa/hAWoM_hAWa/hAWo-hAWa/hAWo_hAWa/Kata_se/Anana-PAnana_meM/AnanaPAnana_meM/siwAba/siwAbI/besAKwA/TahAkA/ikahAI/ikahAU
Barapeta	Barapeta/petaBara
agrawaH	Age/agrawaH
TIka-TAka	TIka-TAka/TIkaTAka/TIka/acCA/baDiyA/sakuSala/kuSalawApUrvaka/kuSalapUrvaka/sahI_salAmawa/sahI-salAmawa/TIka-TAka/TIka_se/TIka-TAka_se/TIkaTAka/baKEra/baKEra/baKErIya/baKErIyawa/surakRiwawaH
kAPI	bahuwa/KUba/KUba/badA/jyAxA/jyAxA/aXika/kAPI/kAPI/kadA/jamakara/datakara/paryApwa/kAPI/kAPI/yaWeRta/alam/alaM
ikahAI	acAnaka/ekAeka/sahasA/ekabAragI/ikabAragI/yakAyaka/akasmAwa/akasmAw/anAyAsa/xEvAw/xEvavaSa/Ocaka/aprawyASiwawaH/ApAwawaH/aFcakEM/agawyA/acaka/acAFcaka/acAkA/acAka/acAna/anAgawaH/anyAsa/nAgahAz/AcAna/ikahAI/ikahAU/iwwiPAkana/iwwiPAkana/iwwaPAkana/iwwaPAkana/ucakA/Ocaka/Jatapata/catapata/PatAPata/wuranwa/wuranwa/wawkAla/avilamba/avilamba/POrana/POrana/KatAka_se/wawkRaNa/wadAka_se/wada_se/wapAka_se/awiSIGra/awiSIGrawaH/jalxa_se_jalxa/jalxI_se_jalxI/wada_se/hAWoM-hAWa/hAWoM_hAWa/hAWo-hAWa/hAWo_hAWa/Kata_se/Anana-PAnana_meM/AnanaPAnana_meM/siwAba/siwAbI/besAKwA/TahAkA/ikahAI/ikahAU
aBI_aBI	aBI-aBI/aBI_aBI/aBI_hI/isI_vakwa/isI_kRaNa
virAmawaH	ruka-ruka_kara/ruka-rukakara/virAmawaH/Tahara_Tahara_kara/savirAmawaH
Sawa-prawiSawa	bilkula/bilakula/ekaxama/nipata/sarAsara/TIka/niwAnwa/niwAnwa/pUrNawaH/pUrI_waraha_se/pUrNawayA/sampUrNawaH/sampUrNawayA/pUrNarupeNa/AmUlacUla/Sawa-prawiSawa
isI_prakAra	isI_waraha/isI_prakAra/iwWaMmeva
AxeSa_se	AjFApUrvaka/AxeSapUrvaka/sAxeSa/AxeSa_se
baDAcaDAkara	baDA-caDAkara/baDAcaDAkara
iwimAwra	iwanA_hI/iwimAwra
AjakAla	PilahAla/PilahAla/aba/varwamAna_meM/Aja-kala/Ajakala/Aja_kala/AjakAla/ina_xinoM/isa_samaya/samprawi
AsAnI_se	AsAnI_se/sahajawA_se/saralawA_se/Kela_Kela_meM/sahajawaH/anEse
cAroM_ora	cAroM_ora/cAroM_waraPa/cAroM_waraPa/cahuz_ora/sarvawra/saBI_waraPa/cAroM_xiSAoM_meM/hara_jagaha/irxa-girxa
wanahA	akelA/akele/kevala/sirPa/mAwra/KAlI/KAlI/basa/nipata/mahaja/sirPa/wanhA/wanahA/ekAkI/ekameva/ekafga/ikelA
TaNde_TaNde	TaNde-TaNde/TaNde_TaNde/TaNDe-TaNDe/TaNDe_TaNDe
aXikawaH	aXikawaH/aXikAMSawaH/prAyaH/aXikAMSawayA
prayawnahInawaH	anAyAsa/binA_pariSrama/aprayawnawaH/prayawnahInawaH/ayAsa
wuranwa	Jatapata/catapata/PatAPata/wuranwa/wuranwa/wawkAla/avilamba/avilamba/POrana/POrana/KatAka_se/wawkRaNa/wadAka_se/wada_se/wapAka_se/awiSIGra/awiSIGrawaH/jalxa_se_jalxa/jalxI_se_jalxI/wada_se/hAWoM-hAWa/hAWoM_hAWa/hAWo-hAWa/hAWo_hAWa/Kata_se/Anana-PAnana_meM/AnanaPAnana_meM/siwAba/siwAbI/besAKwA/TahAkA/ikahAI/ikahAU
IrRyApUrvaka	IrRyApUrvaka/IrRyawaH/xveRapUrvaka/sAsUya/IrRyApUrNawaH
CaHgunA	CahagunA/COgunA/CaHgunA
iwauwa	iXara-uXara/jahAz-wahAz/yahAz-vahAz/iwauwa/iwaswawaH
acaka	acAnaka/ekAeka/sahasA/ekabAragI/ikabAragI/yakAyaka/akasmAwa/akasmAw/anAyAsa/xEvAw/xEvavaSa/Ocaka/aprawyASiwawaH/ApAwawaH/aFcakEM/agawyA/acaka/acAFcaka/acAkA/acAka/acAna/anAgawaH/anyAsa/nAgahAz/AcAna/ikahAI/ikahAU/iwwiPAkana/iwwiPAkana/iwwaPAkana/iwwaPAkana/ucakA/Ocaka
prayawnapUrvaka	prayawnapUrvaka/sAyAsa/prayawnawaH/prayawna_se
kala	kala/kAlha/kala
aBisWira	aBisWira
wadAka_se	Jatapata/catapata/PatAPata/wuranwa/wuranwa/wawkAla/avilamba/avilamba/POrana/POrana/KatAka_se/wawkRaNa/wadAka_se/wada_se/wapAka_se/awiSIGra/awiSIGrawaH/jalxa_se_jalxa/jalxI_se_jalxI/wada_se/hAWoM-hAWa/hAWoM_hAWa/hAWo-hAWa/hAWo_hAWa/Kata_se/Anana-PAnana_meM/AnanaPAnana_meM/siwAba/siwAbI/besAKwA/TahAkA/ikahAI/ikahAU/wada_se/wadAka_se
hUbahU	prawirUpawaH/hUbahU/hU-ba-hU
hameSA_kI_waraha	hasbemAmUla/hasbe-mAmUla/hasba-e-mAmUla/hameSA_kI_waraha
xayApUrvaka	xayApUrvaka/kqpA_kara_ke/kqpApUrvaka/xayA_se/barAe_meharabAnI
jahAz	jahAz
xerI_se	vilambawaH/aSIGrawaH/xerI_se/vilambapUrvaka/xera_meM
UzcAI_para	Upara/UzcAI_para/UrxXva/UrXva
kisI_samaya	kaBI/kisI_samaya
apalaka	apalaka/nirnimeRa/nirnimiRa/nirnimeKa
kAraNavaSa	kAraNavaSa/kAraNawaH
Asafga	lagAwAra/anavarawa/niranwara/niranwara/wAbadawoda/xanAxana/sawawa/XUAzXAra/ananwara/ananwara/avirAmawaH/aniSa/prawikRaNa/anukRaNa/XadAXada/avirawa/muwwasila/avicCinna/avicCexa/aviSrAnwa/aviSrAnwa/asarAra/aharaha/Asafga/Asafga/ikawAra
anwa_meM	anwawaH/anwawogawvA/anwa_meM/AKira/AKira/AKirakAra/AKirakAra/howe_havAwe
waxananwara	wawapaScAwa/waxananwara/waxauparAnwa/waxoparAnwa/waxanwara/waxananwara/waxuparAnwa/waxuparAnwa/waxoparAnwa/waxoparAnwa/waxanwara
svawaH	svayaM/svawaH/Kuxa/Kuxa/Apa/ApahI/apaneApa/Kuxa_hI/sAkRAw/sAkRAwa/asAlawana/AparUpa/svawaH/apaneApa/Kuxa-ba-Kuxa/KuxabaKuxa/Kuxa-ba-Kuxa/KuxabaKuxa
Are	pAsa_meM/najaxIka/najaxIka/nikata_meM/karIba_meM/samIpa/nikata/pAsa/karIba/karIba/sannikata/najIka/muwwasila/arvAka/avixUra/Are/AsapAsa/Asa-pAsa
muAPika	anusAra/mAPika/muwAbika/anukUla/muAPika/muAPika/muwAbika/aprawIRa
viXivawa	viXipUrvaka/kAyaxe_se/Dafga_se/warIke_se/bawOra/bAkAyaxA/viXivaw/viXivawa
hakIkawana	vAkaI/vAkaI/vAswava_meM/hakIkawana/hakIkawana/xaraasala/asala_meM/sacamuca/saccI-muccI/saccI_muccI/sawyawaH/vaswuwaH
xera_meM	vilambawaH/aSIGrawaH/xerI_se/vilambapUrvaka/xera_meM
karInAvAra	warIke_se/warIke_se/warawIba_se/karIne_se/karIne_se/vyavasWApUrvaka/vyavasWiwawaH/karInAvAra/karInAvAra
besoce_samaJe	vicArahInawaH/anasoce/besoce_samaJe
cAragunA	cOgunA/cAra_gunA/cAragunA/cawurguNa
soca_samaJa_kara	soca-vicArakara/samaJa-bUJakara/vicArapUrvaka/soca-samaJakara/soca_vicAra_kara/samaJa_bUJa_kara/soca_samaJa_kara/vicAriwawaH
bewarIke	viXihInawaH/kuviXipUrvaka/bewarIke
hara_kRaNa	prawikRaNa/pala_pala/pala-pala/prawipala/hara_kRaNa/kRaNa-kRaNa/haraGadI/hara_GadI/prawi_kRaNa/kRaNakRaNa/anukRaNa/CinaCina/Cina-Cina/AKana
awIwa_meM	awIwa_meM/pahale/BUwa_meM/BUwa_kAla_meM/pICe/piCale_xinoM_meM
aBimAna_se	aBimAnapUrvaka/aBimAna_se/sagarva/sABimAna
AxyAnwa	AxyopAnwa/AxyopAnwa/AxyAnwa/AxyAnwa
bAijjawa	bAijjawa/bAijjawa/sasammAna
xinoM-xina	xina-prawixina/xina-xina/xina-para-xina/xina-baxina/xina-ba_xina/xinaprawixina/xinaxina/xinabaxina/xinoM-xina/xinoMxina
teDA	wiraCA/wiryaka/AdA/teDA/bAzkA/wirapata
anekaSaH	kaI_bAra/bahuwa_bAra/anekaSaH
kaTinAI_se	kaTinAI_se/jEse_wEse/muSkila_se/bamuSkila/kaTinawaH/nITi
bIcobIca	bIcobIca/bIcoMbIca/bIcoM-bIca/bIcama_bIca/bIcoM_bIca
acAka	acAnaka/ekAeka/sahasA/ekabAragI/ikabAragI/yakAyaka/akasmAwa/akasmAw/anAyAsa/xEvAw/xEvavaSa/Ocaka/aprawyASiwawaH/ApAwawaH/aFcakEM/agawyA/acaka/acAFcaka/acAkA/acAka/acAna/anAgawaH/anyAsa/nAgahAz/AcAna/ikahAI/ikahAU/iwwiPAkana/iwwiPAkana/iwwaPAkana/iwwaPAkana/ucakA/Ocaka
siwAba	Jatapata/catapata/PatAPata/wuranwa/wuranwa/wawkAla/avilamba/avilamba/POrana/POrana/KatAka_se/wawkRaNa/wadAka_se/wada_se/wapAka_se/awiSIGra/awiSIGrawaH/jalxa_se_jalxa/jalxI_se_jalxI/wada_se/hAWoM-hAWa/hAWoM_hAWa/hAWo-hAWa/hAWo_hAWa/Kata_se/Anana-PAnana_meM/AnanaPAnana_meM/siwAba/siwAbI/besAKwA/TahAkA/ikahAI/ikahAU
isI_kAraNa	waBI/isI_kAraNa
burA	burA/KarAba/burI_waraha
usI_GadI	waBI/waba_hI/usI_samaya/usI_GadI
roja	prawixina/haraxina/niwya/hararoja/roja/niwa/roja/rojAnA/rojAnA/anuxina/niwyaprawi/anuxivasa/aharaha
be-iMwahA	awyanwa/awyanwa/awyaXika/be-iMwahA/beiMwahA/bahuwa_aXika/bahuwa_hI/bepanAha/saKwa/saKwa/jamakara/mahA/nihAyawa/cUdAnwa/cUdAnwa/aByaXika/Agara
Barose	Barose/mAWe
saxA	hameSA/saxA/niwya/saxEva/niwya_prawi/sarvaxA/sarvaWA/haraxama/haravakwa/harasamaya/xina-rAwa/xinarAwa/xina_rAwa/rAwa-xina/rAwaxina/niSixina/nisa-vAsara/nisavAsara/niSivAsara/niranwara/niranwara/anavaXi/sarvaxEva/aharaha/pinnA/aharniSa/ahorAwra
iwWe	iXara/isa_ora/yahAz_para/iwaH/iwa/iwE/iwWe
acAkA	acAnaka/ekAeka/sahasA/ekabAragI/ikabAragI/yakAyaka/akasmAwa/akasmAw/anAyAsa/xEvAw/xEvavaSa/Ocaka/aprawyASiwawaH/ApAwawaH/aFcakEM/agawyA/acaka/acAFcaka/acAkA/acAka/acAna/anAgawaH/anyAsa/nAgahAz/AcAna/ikahAI/ikahAU/iwwiPAkana/iwwiPAkana/iwwaPAkana/iwwaPAkana/ucakA/Ocaka
jahAz-wahAz	iXara-uXara/jahAz-wahAz/yahAz-vahAz/iwauwa/iwaswawaH
bArIkI_se	bArIkI_se/bArIkI_se/sUkRmawaH
kAraNa_se	prayojanawaH/kAma_se/kAraNa_se/saprayojana
nAgahAz	acAnaka/ekAeka/sahasA/ekabAragI/ikabAragI/yakAyaka/akasmAwa/akasmAw/anAyAsa/xEvAw/xEvavaSa/Ocaka/aprawyASiwawaH/ApAwawaH/aFcakEM/agawyA/acaka/acAFcaka/acAkA/acAka/acAna/anAgawaH/anyAsa/nAgahAz/AcAna/ikahAI/ikahAU/iwwiPAkana/iwwiPAkana/iwwaPAkana/iwwaPAkana/ucakA/Ocaka
TIkaTAka	TIka-TAka/TIkaTAka/TIka/acCA/baDiyA/sakuSala/kuSalawApUrvaka/kuSalapUrvaka/sahI_salAmawa/sahI-salAmawa/TIka-TAka/TIka_se/TIka-TAka_se/TIkaTAka/baKEra/baKEra/baKErIya/baKErIyawa/surakRiwawaH
vaswuwaH	vAkaI/vAkaI/vAswava_meM/hakIkawana/hakIkawana/xaraasala/asala_meM/sacamuca/saccI-muccI/saccI_muccI/sawyawaH/vaswuwaH
pqRTawaH	pICe/paScawaH/pACe/pqRTawaH/arvAka
anAyAsa	acAnaka/ekAeka/sahasA/ekabAragI/ikabAragI/yakAyaka/akasmAwa/akasmAw/anAyAsa/xEvAw/xEvavaSa/Ocaka/aprawyASiwawaH/ApAwawaH/aFcakEM/agawyA/acaka/acAFcaka/acAkA/acAka/acAna/anAgawaH/anyAsa/nAgahAz/AcAna/ikahAI/ikahAU/iwwiPAkana/iwwiPAkana/iwwaPAkana/iwwaPAkana/ucakA/Ocaka/anAyAsa/binA_pariSrama/aprayawnawaH/prayawnahInawaH/ayAsa
bexarxI_se	nirxayawApUrvaka/nirxayawA_se/berahamI_se/bexarxI_se/krUrawApUrvaka/barbarawApUrvaka/kaTorawA_se/kadAI_se
Aja_kala	PilahAla/PilahAla/aba/varwamAna_meM/Aja-kala/Ajakala/Aja_kala/AjakAla/ina_xinoM/isa_samaya/samprawi
pUrNawayA	bilkula/bilakula/ekaxama/nipata/sarAsara/TIka/niwAnwa/niwAnwa/pUrNawaH/pUrI_waraha_se/pUrNawayA/sampUrNawaH/sampUrNawayA/pUrNarupeNa/AmUlacUla/Sawa-prawiSawa
AramBa_meM	AramBa_meM/AramBawaH/AramBawaH/pahale/SurU_meM/praWama/Axi_meM/praWamawaH/sarvapraWama/pUrva/SuruAwa_meM/SuruvAwa_meM/AramBa_meM/prAramBa_meM
KAsawOra_se	viSeRakara/KAsakara/KAsa_wOra_para/KAsa_wOra_se/KAsawOra_para/KAsawOra_se/KAsawOra_para/KAsawOra_se/KAsakara/viSeRawaH/viSiRtawaH/muKyawaH/viSeRa_rUpa_se
pahale_pahala	pahale_pahala/praWamawaH/sarva_praWama/sarvapraWama/SurU_meM/pahale-pahala/avvalana/pahile_pahala/pahile_pahala
AKira	anwawaH/anwawogawvA/anwa_meM/AKira/AKira/AKirakAra/AKirakAra/howe_havAwe
harasamaya	hameSA/saxA/niwya/saxEva/niwya_prawi/sarvaxA/sarvaWA/haraxama/haravakwa/harasamaya/xina-rAwa/xinarAwa/xina_rAwa/rAwa-xina/rAwaxina/niSixina/nisa-vAsara/nisavAsara/niSivAsara/niranwara/niranwara/anavaXi/sarvaxEva/aharaha/pinnA/aharniSa/ahorAwra
soca-samaJakara	soca-vicArakara/samaJa-bUJakara/vicArapUrvaka/soca-samaJakara/soca_vicAra_kara/samaJa_bUJa_kara/soca_samaJa_kara/vicAriwawaH
KarAba	burA/KarAba/burI_waraha
animiwwa	akAraNa/bemawalaba/niRkAraNa/kAraNahInawaH/animiwwa
niSciwawaH	niHsanxeha/nissanxeha/jarUra/jarUra/niHsanxeha/nissanxeha/nisanxeha/nisanxeha/binA_Saka/beSaka/bilkula/bilakula/yakInana/yakInana/avaSyameva/avaSya/alabawwA/bilASaka/aBarama/vASiMxA/bASiMxA/avasi/aviwarkika/asaMSaya/niSciwawaH/ikafka
kaBI-kaBAra	kaBIkaBI/kaBIkaBAra/yaxAkaxA/kaBI-kaBI/kaBI-kaBAra/yaxA-kaxA/vakwan-POvakwan
aprawyASiwawaH	acAnaka/ekAeka/sahasA/ekabAragI/ikabAragI/yakAyaka/akasmAwa/akasmAw/anAyAsa/xEvAw/xEvavaSa/Ocaka/aprawyASiwawaH/ApAwawaH/aFcakEM/agawyA/acaka/acAFcaka/acAkA/acAka/acAna/anAgawaH/anyAsa/nAgahAz/AcAna/ikahAI/ikahAU/iwwiPAkana/iwwiPAkana/iwwaPAkana/iwwaPAkana/ucakA/Ocaka
pinnA	hameSA/saxA/niwya/saxEva/niwya_prawi/sarvaxA/sarvaWA/haraxama/haravakwa/harasamaya/xina-rAwa/xinarAwa/xina_rAwa/rAwa-xina/rAwaxina/niSixina/nisa-vAsara/nisavAsara/niSivAsara/niranwara/niranwara/anavaXi/sarvaxEva/aharaha/pinnA/aharniSa/ahorAwra
sAmAnyawaH	sAmAnyawaH/sAmAnyawayA/sAXAraNawaH/sAXAraNawayA/amUmana/umUmana
IxqSa	yoM/yUz/Ese/isa_waraha/isa_prakAra/EsA/iwWaM/ima/imi/iBa/iva/isE/IxqS/IxqSa
asarAra	lagAwAra/anavarawa/niranwara/niranwara/wAbadawoda/xanAxana/sawawa/XUAzXAra/ananwara/ananwara/avirAmawaH/aniSa/prawikRaNa/anukRaNa/XadAXada/avirawa/muwwasila/avicCinna/avicCexa/aviSrAnwa/aviSrAnwa/asarAra/aharaha/Asafga/Asafga/ikawAra
PajUla	vyarWa_hI/yoM_hI/JUTa-mUTa/yOM_hI/yUz_hI/Ese_hI/nAhaka/nAhaka/PajUla/PajUla/PijUla/PijUla/anahaka/anAhaka
jEsA	jEsA/jEse/jisa_prakAra/jisa_prakAra_se
Axara_sahiwa	sawkArapUrvaka/sAxara/sasammAna/Axara_sahiwa
alpawaH	alpawaH/WodA-WodA/WodA_WodA/alpaSaH
jora-Sora_se	jora-Sora_se/jora-Sora_se/joraSora_se/joraSora_se/joroM_se/joroM_se
yaxAkaxA	kaBIkaBI/kaBIkaBAra/yaxAkaxA/kaBI-kaBI/kaBI-kaBAra/yaxA-kaxA/vakwan-POvakwan
hAWoM_hAWa	Jatapata/catapata/PatAPata/wuranwa/wuranwa/wawkAla/avilamba/avilamba/POrana/POrana/KatAka_se/wawkRaNa/wadAka_se/wada_se/wapAka_se/awiSIGra/awiSIGrawaH/jalxa_se_jalxa/jalxI_se_jalxI/wada_se/hAWoM-hAWa/hAWoM_hAWa/hAWo-hAWa/hAWo_hAWa/Kata_se/Anana-PAnana_meM/AnanaPAnana_meM/siwAba/siwAbI/besAKwA/TahAkA/ikahAI/ikahAU
jEse	jEsA/jEse/jisa_prakAra/jisa_prakAra_se
ekataka	takatakI_se/ekataka/tukura_tukura/taka-taka/animeRa/animiRa/animiKa/anamiKa/ikataka
aSIGrawaH	vilambawaH/aSIGrawaH/xerI_se/vilambapUrvaka/xera_meM
pUrA	pUrA/pUrI_waraha
xasagunA	xasagunA/xaSagunA/xasa_gunA/xaSa_gunA
maraNoparAnwa	maraNoparAnwa/maraNoparAnwa
yaWAkarma	yaWAkarma/karmAnusAra
labareja	labAlaba/labareja/labareja
avicCexa	lagAwAra/anavarawa/niranwara/niranwara/wAbadawoda/xanAxana/sawawa/XUAzXAra/ananwara/ananwara/avirAmawaH/aniSa/prawikRaNa/anukRaNa/XadAXada/avirawa/muwwasila/avicCinna/avicCexa/aviSrAnwa/aviSrAnwa/asarAra/aharaha/Asafga/Asafga/ikawAra
badA	bahuwa/KUba/KUba/badA/jyAxA/jyAxA/aXika/kAPI/kAPI/kadA/jamakara/datakara
ciMwiwawaH	ciMwiwawaH/uxvignawaH/uxvignawApUrvaka
svAXInawaH	svAXInawaH/svawanwra_rUpa_se
jEse_ho	jEse_ho/jEse_BI_ho
uxAharaNa_svarUpa	uxAharaNArWa/uxAharaNawaH/uxAharaNa_svarUpa/masalana
kuCa	kuCa
Ajawaka	aba_waka/aBI_waka/Aja_waka/abawaka/aBIwaka/Ajawaka/ajahuz/ajahUz/ajo/ajOM/abalaga
AparUpa	svayaM/svawaH/Kuxa/Kuxa/Apa/ApahI/apaneApa/Kuxa_hI/sAkRAw/sAkRAwa/asAlawana/AparUpa
usa_ora	uXara/usa_ora/pare/uwa/uwana
Kuxa-ba-Kuxa	svawaH/apaneApa/Kuxa-ba-Kuxa/KuxabaKuxa/Kuxa-ba-Kuxa/KuxabaKuxa
wawapaScAwa	wawapaScAwa/waxananwara/waxauparAnwa/waxoparAnwa/waxanwara/waxananwara/waxuparAnwa/waxuparAnwa/waxoparAnwa/waxoparAnwa/waxanwara
hAWa_se	hAWa_se/hAWa_xvArA/haswacAliwa_Dafga_se/haswacAlana_xvArA
ekAeka	acAnaka/ekAeka/sahasA/ekabAragI/ikabAragI/yakAyaka/akasmAwa/akasmAw/anAyAsa/xEvAw/xEvavaSa/Ocaka/aprawyASiwawaH/ApAwawaH/aFcakEM/agawyA/acaka/acAFcaka/acAkA/acAka/acAna/anAgawaH/anyAsa/nAgahAz/AcAna/ikahAI/ikahAU/iwwiPAkana/iwwiPAkana/iwwaPAkana/iwwaPAkana/ucakA/Ocaka
waxuparAnwa	wawapaScAwa/waxananwara/waxauparAnwa/waxoparAnwa/waxanwara/waxananwara/waxuparAnwa/waxuparAnwa/waxoparAnwa/waxoparAnwa/waxanwara
ajahUz	aba_waka/aBI_waka/Aja_waka/abawaka/aBIwaka/Ajawaka/ajahuz/ajahUz/ajo/ajOM/abalaga
sawyawaH	vAkaI/vAkaI/vAswava_meM/hakIkawana/hakIkawana/xaraasala/asala_meM/sacamuca/saccI-muccI/saccI_muccI/sawyawaH/vaswuwaH
bahuwa	bahuwa/KUba/KUba/badA/jyAxA/jyAxA/aXika/kAPI/kAPI/kadA/jamakara/datakara
wiryaka	wiraCA/wiryaka/AdA/teDA/bAzkA/wirapata
anwawaH	anwawaH/anwawogawvA/anwa_meM/AKira/AKira/AKirakAra/AKirakAra/howe_havAwe
mahA	awyanwa/awyanwa/awyaXika/be-iMwahA/beiMwahA/bahuwa_aXika/bahuwa_hI/bepanAha/saKwa/saKwa/jamakara/mahA/nihAyawa/cUdAnwa/cUdAnwa/aByaXika/Agara
asaMSaya	niHsanxeha/nissanxeha/jarUra/jarUra/niHsanxeha/nissanxeha/nisanxeha/nisanxeha/binA_Saka/beSaka/bilkula/bilakula/yakInana/yakInana/avaSyameva/avaSya/alabawwA/bilASaka/aBarama/vASiMxA/bASiMxA/avasi/aviwarkika/asaMSaya/niSciwawaH/ikafka
bAez	bAez/bAez_bAjU/bAyeM
anukUla	anusAra/mAPika/muwAbika/anukUla/muAPika/muAPika/muwAbika/aprawIRa
aXunA	aBI/PilahAla/PilahAla/isa_samaya/aba/aWa/aXunA/samprawi/samprawi/aBU/aBE
aXInawA_meM	parAXInawaH/aXInawA_meM/paravaSawaH
prawivarRa	harasAla/prawivarRa/xarasAla/anuvawsara
marNowwara	marNowwara
nimnawaH	nIce/aXaH/nimnawaH/aXo_xiSA_meM
kiswa_xara_kiswa	kiswavAra/kiswavAra/kiswa_xara_kiswa/kiswoM_meM
jalxI	jalxI/SIGra/SIGrawaH/avilambawaH/jalxa/acira/wUrNa/SiwAba/begi/avalambiwa/avalambiwa/jalxI_se/ASu/avilambiwa/avilambiwa/jalxI/savere/sabere
uparAnwa	bAxa/bAxa_meM/paScAw/uparAnwa/ananwara/paScAwa/uparAnwa/ananwara/pICe/uwwara/aWa/anupaxa/anvakRa
kaBI_na_kaBI	xera-savera/kaBI_na_kaBI
havA_kI_waraPa	havA_ke_anukUla/havAnukUla/havA_kI_ora/havA_kI_waraPa
jalxa	jalxI/SIGra/SIGrawaH/avilambawaH/jalxa/acira/wUrNa/SiwAba/begi/avalambiwa/avalambiwa/jalxI_se/ASu/avilambiwa/avilambiwa
niruxxeSyawaH	uxxeSyahInawaH/niruxxeSya/niruxxeSyawaH
binA_Saka	niHsanxeha/nissanxeha/jarUra/jarUra/niHsanxeha/nissanxeha/nisanxeha/nisanxeha/binA_Saka/beSaka/bilkula/bilakula/yakInana/yakInana/avaSyameva/avaSya/alabawwA/bilASaka/aBarama/vASiMxA/bASiMxA/avasi/aviwarkika/asaMSaya/niSciwawaH/ikafka
vakwan-POvakwan	kaBIkaBI/kaBIkaBAra/yaxAkaxA/kaBI-kaBI/kaBI-kaBAra/yaxA-kaxA/vakwan-POvakwan
waxoparAnwa	wawapaScAwa/waxananwara/waxauparAnwa/waxoparAnwa/waxanwara/waxananwara/waxuparAnwa/waxuparAnwa/waxoparAnwa/waxoparAnwa/waxanwara
kahe_muwAbika	kaWanAnusAra/kahanAnusAra/kahe_muwAbika/kahe_muwAbika/kahe_anusAra
Age	sAmane/Age/samakRa/sammuKa/agre/anvakRa/aBimuKa/xarapeSa/Agala/AgalA/Age/agrawaH/BaviRya_meM/Age/BaviRya_kAla_meM/agawyA/pare/Age/bAxa/aba/Age/AiMxA/AiMxA/AyanxA/AyanxA
ekaxama	bilkula/bilakula/ekaxama/nipata/sarAsara/TIka/niwAnwa/niwAnwa/pUrNawaH/pUrI_waraha_se/pUrNawayA/sampUrNawaH/sampUrNawayA/pUrNarupeNa/AmUlacUla/Sawa-prawiSawa
Kuxa	svayaM/svawaH/Kuxa/Kuxa/Apa/ApahI/apaneApa/Kuxa_hI/sAkRAw/sAkRAwa/asAlawana/AparUpa
Cama-Cama	CamaCama/Cama-Cama
isI_jagaha	yahIM/isI_jagaha/ihavEM
vyarWa_hI	vyarWa_hI/yoM_hI/JUTa-mUTa/yOM_hI/yUz_hI/Ese_hI/nAhaka/nAhaka/PajUla/PajUla/PijUla/PijUla/anahaka/anAhaka
viSvAsa_ke_sAWa	viSvAsa_ke_sAWa/viSvasanIyawA_se/viSvAsapUrvaka
KacAKaca	TasATasa/TuzsATuzsa/KacAKaca/TusATusa
AmUla	AmUla
nirnimiRa	apalaka/nirnimeRa/nirnimiRa/nirnimeKa
utakkara	anXAXunXa/bewahASA/anXAXunXa/anXaXunXa/anXaXunXa/utakkara
gahare	gahare/gaharAI_meM
jyoM_kA_wyoM	jyoM_kA_wyoM/jEse_kA_wEse
sAkRAwa	svayaM/svawaH/Kuxa/Kuxa/Apa/ApahI/apaneApa/Kuxa_hI/sAkRAw/sAkRAwa/asAlawana/AparUpa
wawkRaNa	Jatapata/catapata/PatAPata/wuranwa/wuranwa/wawkAla/avilamba/avilamba/POrana/POrana/KatAka_se/wawkRaNa/wadAka_se/wada_se/wapAka_se/awiSIGra/awiSIGrawaH/jalxa_se_jalxa/jalxI_se_jalxI/wada_se/hAWoM-hAWa/hAWoM_hAWa/hAWo-hAWa/hAWo_hAWa/Kata_se/Anana-PAnana_meM/AnanaPAnana_meM/siwAba/siwAbI/besAKwA/TahAkA/ikahAI/ikahAU
uxvignawaH	ciMwiwawaH/uxvignawaH/uxvignawApUrvaka
xina_rAwa	hameSA/saxA/niwya/saxEva/niwya_prawi/sarvaxA/sarvaWA/haraxama/haravakwa/harasamaya/xina-rAwa/xinarAwa/xina_rAwa/rAwa-xina/rAwaxina/niSixina/nisa-vAsara/nisavAsara/niSivAsara/niranwara/niranwara/anavaXi/sarvaxEva/aharaha/pinnA/aharniSa/ahorAwra
kyUzkara	kyoMkara/kyUzkara/kEse
pICe	pICe/paScawaH/pACe/pqRTawaH/arvAka/bAxa/bAxa_meM/paScAw/uparAnwa/ananwara/paScAwa/uparAnwa/ananwara/pICe/uwwara/aWa/anupaxa/anvakRa/awIwa_meM/pahale/BUwa_meM/BUwa_kAla_meM/pICe/piCale_xinoM_meM
samewa	sahiwa/samewa
bevajaha	akAraNa/prayojanahInawaH/Ese_hI/yUz_hI/kAraNahInawaH/bevajaha/uxxeSyahInawaH
pUrvavaw	pUrvavaw/pUrvavawa
paravaSawaH	parAXInawaH/aXInawA_meM/paravaSawaH
lihAjA	isalie/isIlie/awaeva/awaH/lihAjA/lihAjA
xaraasala	vAkaI/vAkaI/vAswava_meM/hakIkawana/hakIkawana/xaraasala/asala_meM/sacamuca/saccI-muccI/saccI_muccI/sawyawaH/vaswuwaH
kalyANArWa	hiwArWa/kalyANArWa
wulanA_meM	apekRAkqwa/wulanA_meM/apekRayA/mukAbale/mukAbale/banisbawa/se
spaRtawaH	spaRta/spaRtawaH/Kula_kara/Kule_wOra_para/Kullama_KullA/binA_lAga_lapeta_ke/sAPa_sAPa/spaRtawayA/sAPa-sAPa/sAPa-sAPa
awarasoM	narasoM/awarasoM/warasoM/narasoM/awarasoM/warasoM
ukavAz	anxAjana/anxAjana/anxAjana/anxAjana/lagaBaga/wakarIbana/wakarIbana/karIba/karIba/karIbakarIba/karIbana/karIbakarIba/karIbana/anumAnawaH/anakarIba/anakarIba/waKamInana/anxAja_se/ukavAz
saKwa	awyanwa/awyanwa/awyaXika/be-iMwahA/beiMwahA/bahuwa_aXika/bahuwa_hI/bepanAha/saKwa/saKwa/jamakara/mahA/nihAyawa/cUdAnwa/cUdAnwa/aByaXika/Agara
AcAna	acAnaka/ekAeka/sahasA/ekabAragI/ikabAragI/yakAyaka/akasmAwa/akasmAw/anAyAsa/xEvAw/xEvavaSa/Ocaka/aprawyASiwawaH/ApAwawaH/aFcakEM/agawyA/acaka/acAFcaka/acAkA/acAka/acAna/anAgawaH/anyAsa/nAgahAz/AcAna/ikahAI/ikahAU/iwwiPAkana/iwwiPAkana/iwwaPAkana/iwwaPAkana/ucakA/Ocaka
pariNAma_svarUpa	PalasvarUpa/pariNAma_svarUpa/pariNAmasvarUpa/pariNAmawaH/PalawaH/nawIjawana
sare-Ama	KuleAma/Kulakara/sareAma/sare-Ama/Kule-Ama/Kullama-KullA/KullamaKullA/dafke_kI_cota_para/sare_Ama/agupwawaH
silasilevAra	kramaSaH/kramAnusAra/yaWAkrama/silasilevAra/bArI-bArI_se/kramavAra/warawIbavAra/ayugapaxa/alpaSaH
galawa_samaya_para	asamaya/bevakwa/bevakwa/galawa_samaya_para/galawa_samaya_para/bemOke
UrXva	Upara/UzcAI_para/UrxXva/UrXva
waba_waka	waba_waka
begi	jalxI/SIGra/SIGrawaH/avilambawaH/jalxa/acira/wUrNa/SiwAba/begi/avalambiwa/avalambiwa/jalxI_se/ASu/avilambiwa/avilambiwa
KAlI	akelA/akele/kevala/sirPa/mAwra/KAlI/KAlI/basa/nipata/mahaja/sirPa/wanhA/wanahA/ekAkI/ekameva/ekafga/ikelA
lihAjA	isalie/isIlie/awaeva/awaH/lihAjA/lihAjA
ekabAragI	acAnaka/ekAeka/sahasA/ekabAragI/ikabAragI/yakAyaka/akasmAwa/akasmAw/anAyAsa/xEvAw/xEvavaSa/Ocaka/aprawyASiwawaH/ApAwawaH/aFcakEM/agawyA/acaka/acAFcaka/acAkA/acAka/acAna/anAgawaH/anyAsa/nAgahAz/AcAna/ikahAI/ikahAU/iwwiPAkana/iwwiPAkana/iwwaPAkana/iwwaPAkana/ucakA/Ocaka
XIre-XIre	XIre-XIre/XIre_XIre/Ahiswe-Ahiswe/AhiswA-AhiswA/hOle-hOle/hole-hole/raPwA-raPwA/alpaSaH
siwAbI	Jatapata/catapata/PatAPata/wuranwa/wuranwa/wawkAla/avilamba/avilamba/POrana/POrana/KatAka_se/wawkRaNa/wadAka_se/wada_se/wapAka_se/awiSIGra/awiSIGrawaH/jalxa_se_jalxa/jalxI_se_jalxI/wada_se/hAWoM-hAWa/hAWoM_hAWa/hAWo-hAWa/hAWo_hAWa/Kata_se/Anana-PAnana_meM/AnanaPAnana_meM/siwAba/siwAbI/besAKwA/TahAkA/ikahAI/ikahAU
TaNDe-TaNDe	TaNde-TaNde/TaNde_TaNde/TaNDe-TaNDe/TaNDe_TaNDe
yaWAsWAna	yaWAsWAna
PajUla	vyarWa/PajUla/PijUla/PijUla/anerA/yoM_hI/vqWA/apArWa/bAxa-havAI/bAxahavAI/ahewu/ahewuka/aviraWA
asaByawaH	asaByawaH/aSiRtawaH/SiRtAcArahInawaH
prayojanawaH	prayojanawaH/kAma_se/kAraNa_se/saprayojana
kaxama-ba_kaxama	pICe-pICe/anupaxa/kaxama-ba_kaxama
PIsaxI	prawiSawa/PIsaxI/PIsaxI/paraseMta
se	apekRAkqwa/wulanA_meM/apekRayA/mukAbale/mukAbale/banisbawa/se
paScawaH	pICe/paScawaH/pACe/pqRTawaH/arvAka
wakarIbana	anxAjana/anxAjana/anxAjana/anxAjana/lagaBaga/wakarIbana/wakarIbana/karIba/karIba/karIbakarIba/karIbana/karIbakarIba/karIbana/anumAnawaH/anakarIba/anakarIba/waKamInana/anxAja_se/ukavAz
pAzcagunA	pAzcagunA/pacagunA
sAvaXAnIpUrvaka	sAvaXAnIpUrvaka/XyAnapUrvaka/XyAna_se/sAvaXAnI_se/sAvaXAnawaH/samBAlakara/samBAlakara
anAhaka	vyarWa_hI/yoM_hI/JUTa-mUTa/yOM_hI/yUz_hI/Ese_hI/nAhaka/nAhaka/PajUla/PajUla/PijUla/PijUla/anahaka/anAhaka
kEse	kEse/kisa_prakAra_se/kyoMkara/kyUzkara/kEse
barbarawApUrvaka	nirxayawApUrvaka/nirxayawA_se/berahamI_se/bexarxI_se/krUrawApUrvaka/barbarawApUrvaka/kaTorawA_se/kadAI_se
iwwiPAkana	acAnaka/ekAeka/sahasA/ekabAragI/ikabAragI/yakAyaka/akasmAwa/akasmAw/anAyAsa/xEvAw/xEvavaSa/Ocaka/aprawyASiwawaH/ApAwawaH/aFcakEM/agawyA/acaka/acAFcaka/acAkA/acAka/acAna/anAgawaH/anyAsa/nAgahAz/AcAna/ikahAI/ikahAU/iwwiPAkana/iwwiPAkana/iwwaPAkana/iwwaPAkana/ucakA/Ocaka/saMyogavaSa/iwwiPAkana/iwwiPAkana/iwwaPAkana/iwwaPAkana/saMyogavaSAw
ArapAra	Ara-pAra/ArapAra
ukadU	ukadUz/ukadU/ukadUz/ukadU/ukurU
jaba_waka	jaba_waka
AdA	wiraCA/wiryaka/AdA/teDA/bAzkA/wirapata
majabUrana	majabUrana/vivaSawaH/anacAhe/majabUrana/vivaSa_hokara/cAranAcAra/anwawogawvA/barabasa
ahora-bahora	bAra-bAra/bAra_bAra/bArambAra/bArambAra/asakqwa/ahora-bahora
adosa-padosa	Asa-pAsa/AsapAsa/agala-bagala/agala-bagala/AjU-bAjU/irxa-girxa/adosa-padosa/pAsa-padosa/pAsa_padosa
nAhaka	vyarWa_hI/yoM_hI/JUTa-mUTa/yOM_hI/yUz_hI/Ese_hI/nAhaka/nAhaka/PajUla/PajUla/PijUla/PijUla/anahaka/anAhaka
barAe_meharabAnI	xayApUrvaka/kqpA_kara_ke/kqpApUrvaka/xayA_se/barAe_meharabAnI
ultA-pultA	ulatA-pulatA/ulatA_pulatA/ulatA-palatA/ultA-paltA/ultA-pultA/ultA_pultA
jiMxagIBara	mqwyuparyanwa/AjIvana/wAumra/umraBara/jiMxagIBara/jiMxagIBara/jIvanaBara/AmaraNa/anwima_xama_waka
aBI_BI	aBI_BI
avilambawaH	jalxI/SIGra/SIGrawaH/avilambawaH/jalxa/acira/wUrNa/SiwAba/begi/avalambiwa/avalambiwa/jalxI_se/ASu/avilambiwa/avilambiwa
Cina-Cina	prawikRaNa/pala_pala/pala-pala/prawipala/hara_kRaNa/kRaNa-kRaNa/haraGadI/hara_GadI/prawi_kRaNa/kRaNakRaNa/anukRaNa/CinaCina/Cina-Cina/AKana
isabAra	aba/abakI/isabAra/aba_kI/isa_bAra
nisafkoca	nisafkoca/niHsafkoca/nissafkoca/beXadaka/safkocahInawaH/beJiJaka/beKataka/beKatake/behicaka
sarAsara	bilkula/bilakula/ekaxama/nipata/sarAsara/TIka/niwAnwa/niwAnwa/pUrNawaH/pUrI_waraha_se/pUrNawayA/sampUrNawaH/sampUrNawayA/pUrNarupeNa/AmUlacUla/Sawa-prawiSawa
uwwara	bAxa/bAxa_meM/paScAw/uparAnwa/ananwara/paScAwa/uparAnwa/ananwara/pICe/uwwara/aWa/anupaxa/anvakRa
jabaraxaswI	balapUrvaka/barabasa/jabaraxaswI/jabaraxaswI/jabarana/jabarana/barajorI
xUra	xUra/xUrI_para/alaga/pare/xarakinAra/xUra/alaga/eka_waraPa/eka_ora/alahaxA
PilahAla	PilahAla/PilahAla/aba/varwamAna_meM/Aja-kala/Ajakala/Aja_kala/AjakAla/ina_xinoM/isa_samaya/samprawi/aBI/PilahAla/PilahAla/isa_samaya/aba/aWa/aXunA/samprawi/samprawi/aBU/aBE
bepanAha	awyanwa/awyanwa/awyaXika/be-iMwahA/beiMwahA/bahuwa_aXika/bahuwa_hI/bepanAha/saKwa/saKwa/jamakara/mahA/nihAyawa/cUdAnwa/cUdAnwa/aByaXika/Agara
xveRahInawaH	IrRyAhInawaH/anasUyawaH/xveRahInawaH
takatakI_se	takatakI_se/ekataka/tukura_tukura/taka-taka/animeRa/animiRa/animiKa/anamiKa/ikataka
anyAsa	acAnaka/ekAeka/sahasA/ekabAragI/ikabAragI/yakAyaka/akasmAwa/akasmAw/anAyAsa/xEvAw/xEvavaSa/Ocaka/aprawyASiwawaH/ApAwawaH/aFcakEM/agawyA/acaka/acAFcaka/acAkA/acAka/acAna/anAgawaH/anyAsa/nAgahAz/AcAna/ikahAI/ikahAU/iwwiPAkana/iwwiPAkana/iwwaPAkana/iwwaPAkana/ucakA/Ocaka
acCI_waraha_se	acCI_waraha/acCI_waraha_se/acCI_waraha/acCI_waraha_se/acCA/baDiyA/acCI_waraha/acCI_waraha_se/tanAtana/TIka/TIka_se/acCI_waraha/acCI_waraha_se/acCI_waraha/acCI_waraha_se
mOna	cupacApa/cupa/mOna/SAnwa/SAnwa/KAmoSI_se/KAmoSI_se/niSSabxa/avAka/avAk/bina_bole/mOnawaH
aTagunA	ATagunA/aTagunA
kramAnusAra	kramaSaH/kramAnusAra/yaWAkrama/silasilevAra/bArI-bArI_se/kramavAra/warawIbavAra/ayugapaxa/alpaSaH
harasAla	harasAla/prawivarRa/xarasAla/anuvawsara
sAsUya	IrRyApUrvaka/IrRyawaH/xveRapUrvaka/sAsUya/IrRyApUrNawaH
nissanxeha	niHsanxeha/nissanxeha/jarUra/jarUra/niHsanxeha/nissanxeha/nisanxeha/nisanxeha/binA_Saka/beSaka/bilkula/bilakula/yakInana/yakInana/avaSyameva/avaSya/alabawwA/bilASaka/aBarama/vASiMxA/bASiMxA/avasi/aviwarkika/asaMSaya/niSciwawaH/ikafka
Kela_Kela_meM	AsAnI_se/sahajawA_se/saralawA_se/Kela_Kela_meM/sahajawaH/anEse
prayawnawaH	prayawnapUrvaka/sAyAsa/prayawnawaH/prayawna_se
bAijjawa	bAijjawa/bAijjawa/sasammAna
KAsakara	viSeRakara/KAsakara/KAsa_wOra_para/KAsa_wOra_se/KAsawOra_para/KAsawOra_se/KAsawOra_para/KAsawOra_se/KAsakara/viSeRawaH/viSiRtawaH/muKyawaH/viSeRa_rUpa_se
jora_se	kasakara/joraxAra/weja/weja/wIvra/wejI_se/jora_se/wejI_se/jora_se/wIvrawA_se
nafge_pEra	nafge_pEra
vyavasWApUrvaka	warIke_se/warIke_se/warawIba_se/karIne_se/karIne_se/vyavasWApUrvaka/vyavasWiwawaH/karInAvAra/karInAvAra
vyavasWiwawaH	warIke_se/warIke_se/warawIba_se/karIne_se/karIne_se/vyavasWApUrvaka/vyavasWiwawaH/karInAvAra/karInAvAra
soca_vicAra_kara	soca-vicArakara/samaJa-bUJakara/vicArapUrvaka/soca-samaJakara/soca_vicAra_kara/samaJa_bUJa_kara/soca_samaJa_kara/vicAriwawaH
anekaXA	prAyaH/akasara/aksara/aXikawara/aXikAMSawaH/jyAxAwara/bahuXA/AmawOra_para/AmawOra_se/aXikAMSawayA/prAyaSaH/anekaXA
Apa	svayaM/svawaH/Kuxa/Kuxa/Apa/ApahI/apaneApa/Kuxa_hI/sAkRAw/sAkRAwa/asAlawana/AparUpa
akaNtaka	nirbAXa/bAXArahiwa/akaNtaka
abakI	aba/abakI/isabAra/aba_kI/isa_bAra
TaNde-TaNde	TaNde-TaNde/TaNde_TaNde/TaNDe-TaNDe/TaNDe_TaNDe
PajUla	vyarWa_hI/yoM_hI/JUTa-mUTa/yOM_hI/yUz_hI/Ese_hI/nAhaka/nAhaka/PajUla/PajUla/PijUla/PijUla/anahaka/anAhaka
WaraWara	Wara-Wara/WaraWara
svaBAvawaH	svaBAvawaH/Axawana
dIMga_mArawe_hue	SeKI_mArawe_hue/dIMga_mArawe_hue
PijUla	vyarWa_hI/yoM_hI/JUTa-mUTa/yOM_hI/yUz_hI/Ese_hI/nAhaka/nAhaka/PajUla/PajUla/PijUla/PijUla/anahaka/anAhaka/vyarWa/PajUla/PijUla/PijUla/anerA/yoM_hI/vqWA/apArWa/bAxa-havAI/bAxahavAI/ahewu/ahewuka/aviraWA
hAjira	peSa/hAjira/hAjira
haraxina	prawixina/haraxina/niwya/hararoja/roja/niwa/roja/rojAnA/rojAnA/anuxina/niwyaprawi/anuxivasa/aharaha
vivaSa_hokara	majabUrana/vivaSawaH/anacAhe/majabUrana/vivaSa_hokara/cAranAcAra/anwawogawvA/barabasa
kyoMkara	kyoMkara/kyUzkara/kEse
joroM_se	jora-Sora_se/jora-Sora_se/joraSora_se/joraSora_se/joroM_se/joroM_se
iwwaPAkana	acAnaka/ekAeka/sahasA/ekabAragI/ikabAragI/yakAyaka/akasmAwa/akasmAw/anAyAsa/xEvAw/xEvavaSa/Ocaka/aprawyASiwawaH/ApAwawaH/aFcakEM/agawyA/acaka/acAFcaka/acAkA/acAka/acAna/anAgawaH/anyAsa/nAgahAz/AcAna/ikahAI/ikahAU/iwwiPAkana/iwwiPAkana/iwwaPAkana/iwwaPAkana/ucakA/Ocaka/saMyogavaSa/iwwiPAkana/iwwiPAkana/iwwaPAkana/iwwaPAkana/saMyogavaSAw
spaRtawayA	spaRta/spaRtawaH/Kula_kara/Kule_wOra_para/Kullama_KullA/binA_lAga_lapeta_ke/sAPa_sAPa/spaRtawayA/sAPa-sAPa/sAPa-sAPa
Binasahare	BinasAre/Binasahare
XUAzXAra	lagAwAra/anavarawa/niranwara/niranwara/wAbadawoda/xanAxana/sawawa/XUAzXAra/ananwara/ananwara/avirAmawaH/aniSa/prawikRaNa/anukRaNa/XadAXada/avirawa/muwwasila/avicCinna/avicCexa/aviSrAnwa/aviSrAnwa/asarAra/aharaha/Asafga/Asafga/ikawAra
anusAra	anusAra/mAPika/muwAbika/anukUla/muAPika/muAPika/muwAbika/aprawIRa
barabasa	majabUrana/vivaSawaH/anacAhe/majabUrana/vivaSa_hokara/cAranAcAra/anwawogawvA/barabasa/balapUrvaka/barabasa/jabaraxaswI/jabaraxaswI/jabarana/jabarana/barajorI
xayA_se	xayApUrvaka/kqpA_kara_ke/kqpApUrvaka/xayA_se/barAe_meharabAnI
alam	basa/alam/alaM/paryApwa/kAPI/kAPI/yaWeRta/alam/alaM
sAmUhika_rUpa_se	samUhawaH/sAmUhika_rUpa_se
anavaXi	hameSA/saxA/niwya/saxEva/niwya_prawi/sarvaxA/sarvaWA/haraxama/haravakwa/harasamaya/xina-rAwa/xinarAwa/xina_rAwa/rAwa-xina/rAwaxina/niSixina/nisa-vAsara/nisavAsara/niSivAsara/niranwara/niranwara/anavaXi/sarvaxEva/aharaha/pinnA/aharniSa/ahorAwra
baje	baje
alaM	basa/alam/alaM/paryApwa/kAPI/kAPI/yaWeRta/alam/alaM
majabUwI_se	xqDawApUrvaka/majabUwI_se/majabUwI_se
asakqwa	bAra-bAra/bAra_bAra/bArambAra/bArambAra/asakqwa/ahora-bahora
AmawOra_se	prAyaH/akasara/aksara/aXikawara/aXikAMSawaH/jyAxAwara/bahuXA/AmawOra_para/AmawOra_se/aXikAMSawayA/prAyaSaH/anekaXA
ekajuta	ekajuta
muwwasila	pAsa_meM/najaxIka/najaxIka/nikata_meM/karIba_meM/samIpa/nikata/pAsa/karIba/karIba/sannikata/najIka/muwwasila/arvAka/avixUra/Are/AsapAsa/Asa-pAsa/lagAwAra/anavarawa/niranwara/niranwara/wAbadawoda/xanAxana/sawawa/XUAzXAra/ananwara/ananwara/avirAmawaH/aniSa/prawikRaNa/anukRaNa/XadAXada/avirawa/muwwasila/avicCinna/avicCexa/aviSrAnwa/aviSrAnwa/asarAra/aharaha/Asafga/Asafga/ikawAra
ulatA_pulatA	ulatA-pulatA/ulatA_pulatA/ulatA-palatA/ultA-paltA/ultA-pultA/ultA_pultA
iXara-uXara	iXara-uXara/jahAz-wahAz/yahAz-vahAz/iwauwa/iwaswawaH
bIcoM_bIca	bIcobIca/bIcoMbIca/bIcoM-bIca/bIcama_bIca/bIcoM_bIca
ina_xinoM	PilahAla/PilahAla/aba/varwamAna_meM/Aja-kala/Ajakala/Aja_kala/AjakAla/ina_xinoM/isa_samaya/samprawi
xqDawApUrvaka	safkalpapUrvaka/irAxawana/irAxe_se/xqDawApUrvaka/niScayapUrvaka/xqDawApUrvaka/majabUwI_se/majabUwI_se
sakuSala	sakuSala/kuSalawApUrvaka/kuSalapUrvaka/sahI_salAmawa/sahI-salAmawa/TIka-TAka/TIka_se/TIka-TAka_se/TIkaTAka/baKEra/baKEra/baKErIya/baKErIyawa/surakRiwawaH
eka_eka_daga	kaxama_ba_kaxama/eka_eka_daga/paxa_prawi_paxa
isa_waraha	yoM/yUz/Ese/isa_waraha/isa_prakAra/EsA/iwWaM/ima/imi/iBa/iva/isE/IxqS/IxqSa
kaxama_ba_kaxama	kaxama_ba_kaxama/eka_eka_daga/paxa_prawi_paxa
abawaka	aba_waka/aBI_waka/Aja_waka/abawaka/aBIwaka/Ajawaka/ajahuz/ajahUz/ajo/ajOM/abalaga
Kule_wOra_para	spaRta/spaRtawaH/Kula_kara/Kule_wOra_para/Kullama_KullA/binA_lAga_lapeta_ke/sAPa_sAPa/spaRtawayA/sAPa-sAPa/sAPa-sAPa
mukAbale	apekRAkqwa/wulanA_meM/apekRayA/mukAbale/mukAbale/banisbawa/se
iwe	iwanA/iwA/iweka/iwe
nisanxeha	niHsanxeha/nissanxeha/jarUra/jarUra/niHsanxeha/nissanxeha/nisanxeha/nisanxeha/binA_Saka/beSaka/bilkula/bilakula/yakInana/yakInana/avaSyameva/avaSya/alabawwA/bilASaka/aBarama/vASiMxA/bASiMxA/avasi/aviwarkika/asaMSaya/niSciwawaH/ikafka
iwa	iXara/isa_ora/yahAz_para/iwaH/iwa/iwE/iwWe/yahAz/isa_jagaha/iwaH/iwa/iha/ihAz/ihavAz/IMGe/IhAz
Anana-PAnana_meM	Jatapata/catapata/PatAPata/wuranwa/wuranwa/wawkAla/avilamba/avilamba/POrana/POrana/KatAka_se/wawkRaNa/wadAka_se/wada_se/wapAka_se/awiSIGra/awiSIGrawaH/jalxa_se_jalxa/jalxI_se_jalxI/wada_se/hAWoM-hAWa/hAWoM_hAWa/hAWo-hAWa/hAWo_hAWa/Kata_se/Anana-PAnana_meM/AnanaPAnana_meM/siwAba/siwAbI/besAKwA/TahAkA/ikahAI/ikahAU
ApahI	svayaM/svawaH/Kuxa/Kuxa/Apa/ApahI/apaneApa/Kuxa_hI/sAkRAw/sAkRAwa/asAlawana/AparUpa
waKamInana	anxAjana/anxAjana/anxAjana/anxAjana/lagaBaga/wakarIbana/wakarIbana/karIba/karIba/karIbakarIba/karIbana/karIbakarIba/karIbana/anumAnawaH/anakarIba/anakarIba/waKamInana/anxAja_se/ukavAz
AKira	anwawaH/anwawogawvA/anwa_meM/AKira/AKira/AKirakAra/AKirakAra/howe_havAwe
iweka	iwanA/iwA/iweka/iwe
iwE	iXara/isa_ora/yahAz_para/iwaH/iwa/iwE/iwWe
iwA	iwanA/iwA/iweka/iwe
samBavawaH	samBavawaH/SAyaxa/syaw
kqpayA	kqpayA/kqpApUrvaka/kqpA_pUrvaka/kqpA_karake/meharabAnI_karake
uXara	uXara/usa_ora/pare/uwa/uwana
sahasA	acAnaka/ekAeka/sahasA/ekabAragI/ikabAragI/yakAyaka/akasmAwa/akasmAw/anAyAsa/xEvAw/xEvavaSa/Ocaka/aprawyASiwawaH/ApAwawaH/aFcakEM/agawyA/acaka/acAFcaka/acAkA/acAka/acAna/anAgawaH/anyAsa/nAgahAz/AcAna/ikahAI/ikahAU/iwwiPAkana/iwwiPAkana/iwwaPAkana/iwwaPAkana/ucakA/Ocaka
anxAjana	anxAjana/anxAjana/anxAjana/anxAjana/lagaBaga/wakarIbana/wakarIbana/karIba/karIba/karIbakarIba/karIbana/karIbakarIba/karIbana/anumAnawaH/anakarIba/anakarIba/waKamInana/anxAja_se/ukavAz
isIlie	isalie/isIlie/awaeva/awaH/lihAjA/lihAjA
bamuSkila	kaTinAI_se/jEse_wEse/muSkila_se/bamuSkila/kaTinawaH/nITi
nisvArWa	nisvArWa/niHsvArWa
isa_samaya	PilahAla/PilahAla/aba/varwamAna_meM/Aja-kala/Ajakala/Aja_kala/AjakAla/ina_xinoM/isa_samaya/samprawi/aBI/PilahAla/PilahAla/isa_samaya/aba/aWa/aXunA/samprawi/samprawi/aBU/aBE
aByaXika	awyanwa/awyanwa/awyaXika/be-iMwahA/beiMwahA/bahuwa_aXika/bahuwa_hI/bepanAha/saKwa/saKwa/jamakara/mahA/nihAyawa/cUdAnwa/cUdAnwa/aByaXika/Agara
kyoM	kyoM/kisalie/kisa_vAswe
xera-savera	xera-savera/kaBI_na_kaBI/xera-savera/avera-savera
sabase_pahale	Age-Age/Age_kI_ora/sabase_pahale
irxa-girxa	cAroM_ora/cAroM_waraPa/cAroM_waraPa/cahuz_ora/sarvawra/saBI_waraPa/cAroM_xiSAoM_meM/hara_jagaha/irxa-girxa/Asa-pAsa/AsapAsa/agala-bagala/agala-bagala/AjU-bAjU/irxa-girxa/adosa-padosa/pAsa-padosa/pAsa_padosa
avyavasWiwa	wiwara-biwara/aswa-vyaswa/Cinna-Binna/bewarawIba/aswavyaswa/_avyavasWiwa
yaWAsamBava	yaWASakwi/Barasaka/yaWAsAXya/yaWAsamBava/kRamawAnusAra/yaWAkRama
AjIvana	mqwyuparyanwa/AjIvana/wAumra/umraBara/jiMxagIBara/jiMxagIBara/jIvanaBara/AmaraNa/anwima_xama_waka
prasannawApUrvaka	prasannawApUrvaka/KuSI_KuSI/KuSI_KuSI/KuSI_se/KuSI_se/prasannawaH/saharRa/harRapUrvaka
baKErIya	sakuSala/kuSalawApUrvaka/kuSalapUrvaka/sahI_salAmawa/sahI-salAmawa/TIka-TAka/TIka_se/TIka-TAka_se/TIkaTAka/baKEra/baKEra/baKErIya/baKErIyawa/surakRiwawaH
KuleAma	KuleAma/Kulakara/sareAma/sare-Ama/Kule-Ama/Kullama-KullA/KullamaKullA/dafke_kI_cota_para/sare_Ama/agupwawaH
jAzca_paraKa_kara	jAzca_paraKakara/jAzca_paraKa_kara
anxAjana	anxAjana/anxAjana/anxAjana/anxAjana/lagaBaga/wakarIbana/wakarIbana/karIba/karIba/karIbakarIba/karIbana/karIbakarIba/karIbana/anumAnawaH/anakarIba/anakarIba/waKamInana/anxAja_se/ukavAz
xarapeSa	sAmane/Age/samakRa/sammuKa/agre/anvakRa/aBimuKa/xarapeSa/Agala/AgalA
UrxXva	Upara/UzcAI_para/UrxXva/UrXva
baKEra	sakuSala/kuSalawApUrvaka/kuSalapUrvaka/sahI_salAmawa/sahI-salAmawa/TIka-TAka/TIka_se/TIka-TAka_se/TIkaTAka/baKEra/baKEra/baKErIya/baKErIyawa/surakRiwawaH
yaxi	yaxi/agara/jaba
wejI_se	kasakara/joraxAra/weja/weja/wIvra/wejI_se/jora_se/wejI_se/jora_se/wIvrawA_se
yaxA	jaba/yaxA
sagarva	aBimAnapUrvaka/aBimAna_se/sagarva/sABimAna
BalIBAzwi	BalI-BAzwi/BalI_BAzwi/BarapUra/BalIBAzwi/BalI-BAnwi/BalI_BAnwi/BalIBAnwi/sarvawoBAva/acCI_waraha
iwwiPAkana	acAnaka/ekAeka/sahasA/ekabAragI/ikabAragI/yakAyaka/akasmAwa/akasmAw/anAyAsa/xEvAw/xEvavaSa/Ocaka/aprawyASiwawaH/ApAwawaH/aFcakEM/agawyA/acaka/acAFcaka/acAkA/acAka/acAna/anAgawaH/anyAsa/nAgahAz/AcAna/ikahAI/ikahAU/iwwiPAkana/iwwiPAkana/iwwaPAkana/iwwaPAkana/ucakA/Ocaka/saMyogavaSa/iwwiPAkana/iwwiPAkana/iwwaPAkana/iwwaPAkana/saMyogavaSAw
ahorAwra	hameSA/saxA/niwya/saxEva/niwya_prawi/sarvaxA/sarvaWA/haraxama/haravakwa/harasamaya/xina-rAwa/xinarAwa/xina_rAwa/rAwa-xina/rAwaxina/niSixina/nisa-vAsara/nisavAsara/niSivAsara/niranwara/niranwara/anavaXi/sarvaxEva/aharaha/pinnA/aharniSa/ahorAwra
niwAnwa	bilkula/bilakula/ekaxama/nipata/sarAsara/TIka/niwAnwa/niwAnwa/pUrNawaH/pUrI_waraha_se/pUrNawayA/sampUrNawaH/sampUrNawayA/pUrNarupeNa/AmUlacUla/Sawa-prawiSawa
kiMkarwavya-vimUDa	hakkA-bakkA/BOMcakkA/kiMkarwavya-vimUDa/kiMkarwwavya-vimUDa/kiMkarwavyavimUDa/kiMkarwwavyavimUDa/hawabuxXi
vivaSawaH	majabUrana/vivaSawaH/anacAhe/majabUrana/vivaSa_hokara/cAranAcAra/anwawogawvA/barabasa
SuruvAwa_meM	AramBa_meM/AramBawaH/AramBawaH/pahale/SurU_meM/praWama/Axi_meM/praWamawaH/sarvapraWama/pUrva/SuruAwa_meM/SuruvAwa_meM/AramBa_meM/prAramBa_meM
nikata	pAsa_meM/najaxIka/najaxIka/nikata_meM/karIba_meM/samIpa/nikata/pAsa/karIba/karIba/sannikata/najIka/muwwasila/arvAka/avixUra/Are/AsapAsa/Asa-pAsa
anuvawsara	harasAla/prawivarRa/xarasAla/anuvawsara
yaWAsAXya	yaWASakwi/Barasaka/yaWAsAXya/yaWAsamBava/kRamawAnusAra/yaWAkRama
ekAkI	akelA/akele/kevala/sirPa/mAwra/KAlI/KAlI/basa/nipata/mahaja/sirPa/wanhA/wanahA/ekAkI/ekameva/ekafga/ikelA
IhAz	yahAz/isa_jagaha/iwaH/iwa/iha/ihAz/ihavAz/IMGe/IhAz
vAswava_meM	vAkaI/vAkaI/vAswava_meM/hakIkawana/hakIkawana/xaraasala/asala_meM/sacamuca/saccI-muccI/saccI_muccI/sawyawaH/vaswuwaH
sIXe	sIXe/sIXA/sIXe/sIXA/sAmane/sIXe/sIXe/sIXA/sIXe/sIXA/sIXe/sIXA
bAra-bAra	bAra-bAra/bAra_bAra/bArambAra/bArambAra/asakqwa/ahora-bahora
AiMxA	aba/Age/AiMxA/AiMxA/AyanxA/AyanxA
acCA_ho_ki	aXimAnawaH/varIyawA_se/acCA_ho_ki
sIXA	sIXe/sIXA/sIXe/sIXA/sAmane/sIXe/sIXA/sIXe/sIXA/sIXe/sIXA
kamobeSa	kamobeSa/kamabeSa/nyUnAXika
ikatTA	sAWa-sAWa/sAWa_hI/sAWa_hI_sAWa/sAWa/eka_sAWa/ikatTA/ikajora/ekawra/ikawra
sAScarya	AScaryapUrvaka/savismaya/sAScarya
hakIkawana	vAkaI/vAkaI/vAswava_meM/hakIkawana/hakIkawana/xaraasala/asala_meM/sacamuca/saccI-muccI/saccI_muccI/sawyawaH/vaswuwaH
soca-vicArakara	soca-vicArakara/samaJa-bUJakara/vicArapUrvaka/soca-samaJakara/soca_vicAra_kara/samaJa_bUJa_kara/soca_samaJa_kara/vicAriwawaH
maxxenajara	maxxenajara/maxxenajara
ukadU	ukadUz/ukadU/ukadUz/ukadU/ukurU
kiswoM_meM	kiswavAra/kiswavAra/kiswa_xara_kiswa/kiswoM_meM
SabxaSaH	akRaraSaH/SabxaSaH/aXyakRara
isI_waraha	isI_waraha/isI_prakAra/iwWaMmeva
iva	yoM/yUz/Ese/isa_waraha/isa_prakAra/EsA/iwWaM/ima/imi/iBa/iva/isE/IxqS/IxqSa/vEse/vEsA/usI_waraha/usa_waraha/iva
kadA	bahuwa/KUba/KUba/badA/jyAxA/jyAxA/aXika/kAPI/kAPI/kadA/jamakara/datakara
saba_meM	saba_meM
Pira_BI	Pira_BI/waWApi/waba_BI
wadAwada	wadAwada
AXAra_para	Upara/AXAra_para
AyanxA	aba/Age/AiMxA/AiMxA/AyanxA/AyanxA
aharniSa	hameSA/saxA/niwya/saxEva/niwya_prawi/sarvaxA/sarvaWA/haraxama/haravakwa/harasamaya/xina-rAwa/xinarAwa/xina_rAwa/rAwa-xina/rAwaxina/niSixina/nisa-vAsara/nisavAsara/niSivAsara/niranwara/niranwara/anavaXi/sarvaxEva/aharaha/pinnA/aharniSa/ahorAwra
sasammAna	sawkArapUrvaka/sAxara/sasammAna/Axara_sahiwa/bAijjawa/bAijjawa/sasammAna
alahaxA	xarakinAra/xUra/alaga/eka_waraPa/eka_ora/alahaxA
ruka-rukakara	ruka-ruka_kara/ruka-rukakara/virAmawaH/Tahara_Tahara_kara/savirAmawaH
girawe_padawe	girawe_padawe/girawe-padawe
bilkula	niHsanxeha/nissanxeha/jarUra/jarUra/niHsanxeha/nissanxeha/nisanxeha/nisanxeha/binA_Saka/beSaka/bilkula/bilakula/yakInana/yakInana/avaSyameva/avaSya/alabawwA/bilASaka/aBarama/vASiMxA/bASiMxA/avasi/aviwarkika/asaMSaya/niSciwawaH/ikafka/bilkula/bilakula/ekaxama/nipata/sarAsara/TIka/niwAnwa/niwAnwa/pUrNawaH/pUrI_waraha_se/pUrNawayA/sampUrNawaH/sampUrNawayA/pUrNarupeNa/AmUlacUla/Sawa-prawiSawa
I_pa	IsA_paScAw/I_pa/edI/IsA_paScAw
taka-taka	takatakI_se/ekataka/tukura_tukura/taka-taka/animeRa/animiRa/animiKa/anamiKa/ikataka
uxAharaNawaH	uxAharaNArWa/uxAharaNawaH/uxAharaNa_svarUpa/masalana
safkocahInawaH	nisafkoca/niHsafkoca/nissafkoca/beXadaka/safkocahInawaH/beJiJaka/beKataka/beKatake/behicaka
kaWanAnusAra	kaWanAnusAra/kahanAnusAra/kahe_muwAbika/kahe_muwAbika/kahe_anusAra
sammuKa	sAmane/Age/samakRa/sammuKa/agre/anvakRa/aBimuKa/xarapeSa/Agala/AgalA
jarA	jarA/jarA/jarA-sA/jarA-sA/rawwiBara/WodA/WodA-sA/WodA_sA/wanika/yawkiMciw
PijUla	vyarWa_hI/yoM_hI/JUTa-mUTa/yOM_hI/yUz_hI/Ese_hI/nAhaka/nAhaka/PajUla/PajUla/PijUla/PijUla/anahaka/anAhaka
cawurguNa	cOgunA/cAra_gunA/cAragunA/cawurguNa
leSamAwra	nAmamAwra/leSamAwra/raFcamAwra/WodA_sA
sannikata	pAsa_meM/najaxIka/najaxIka/nikata_meM/karIba_meM/samIpa/nikata/pAsa/karIba/karIba/sannikata/najIka/muwwasila/arvAka/avixUra/Are/AsapAsa/Asa-pAsa
warIke_se	warIke_se/warIke_se/warawIba_se/karIne_se/karIne_se/vyavasWApUrvaka/vyavasWiwawaH/karInAvAra/karInAvAra
eka_waraPa	eka_ora/eka_waraPa/eka_waraPa
warasoM	narasoM/awarasoM/warasoM/narasoM/awarasoM/warasoM
ulatA-pulatA	ulatA-pulatA/ulatA_pulatA/ulatA-palatA/ultA-paltA/ultA-pultA/ultA_pultA
xvAra-xvAra	xara-xara/xara-baxara/xvAra-xvAra
sampUrNawayA	bilkula/bilakula/ekaxama/nipata/sarAsara/TIka/niwAnwa/niwAnwa/pUrNawaH/pUrI_waraha_se/pUrNawayA/sampUrNawaH/sampUrNawayA/pUrNarupeNa/AmUlacUla/Sawa-prawiSawa
Gara_Gara	Gara-Gara/Gara_Gara
IxqS	yoM/yUz/Ese/isa_waraha/isa_prakAra/EsA/iwWaM/ima/imi/iBa/iva/isE/IxqS/IxqSa
kawaI	kaxApi/haragija/kawaI/kawwaI
viXipUrvaka	viXipUrvaka/kAyaxe_se/Dafga_se/warIke_se/bawOra/bAkAyaxA/viXivaw/viXivawa
muwAbika	anusAra/mAPika/muwAbika/anukUla/muAPika/muAPika/muwAbika/aprawIRa
mAWe	Barose/mAWe
sAvaXAnawaH	sAvaXAnIpUrvaka/XyAnapUrvaka/XyAna_se/sAvaXAnI_se/sAvaXAnawaH/samBAlakara/samBAlakara
karIba_meM	pAsa_meM/najaxIka/najaxIka/nikata_meM/karIba_meM/samIpa/nikata/pAsa/karIba/karIba/sannikata/najIka/muwwasila/arvAka/avixUra/Are/AsapAsa/Asa-pAsa
uxxeSyawaH	uxxeSyapUrvaka/uxxeSyawaH/sABiprAyaH/soxxeSya
sABimAna	aBimAnapUrvaka/aBimAna_se/sagarva/sABimAna
aBimuKa	sAmane/Age/samakRa/sammuKa/agre/anvakRa/aBimuKa/xarapeSa/Agala/AgalA
anakarIba	anxAjana/anxAjana/anxAjana/anxAjana/lagaBaga/wakarIbana/wakarIbana/karIba/karIba/karIbakarIba/karIbana/karIbakarIba/karIbana/anumAnawaH/anakarIba/anakarIba/waKamInana/anxAja_se/ukavAz
aBI_waka	aba_waka/aBI_waka/Aja_waka/abawaka/aBIwaka/Ajawaka/ajahuz/ajahUz/ajo/ajOM/abalaga
bemOke	kusamaya/galawa_vakwa_para/asamaya/bevakwa/galawa_vakwa_para/bevakwa/bemOke/asamaya/bevakwa/bevakwa/galawa_samaya_para/galawa_samaya_para/bemOke
nAhaka	vyarWa_hI/yoM_hI/JUTa-mUTa/yOM_hI/yUz_hI/Ese_hI/nAhaka/nAhaka/PajUla/PajUla/PijUla/PijUla/anahaka/anAhaka
bIcoMbIca	bIcobIca/bIcoMbIca/bIcoM-bIca/bIcama_bIca/bIcoM_bIca
kiXara	kiXara
samAnAnwara	samAnwara/samAnAnwara/samAnwara/samAnAnwara
kiswavAra	kiswavAra/kiswavAra/kiswa_xara_kiswa/kiswoM_meM
yahAz-vahAz	iXara-uXara/jahAz-wahAz/yahAz-vahAz/iwauwa/iwaswawaH
niwya	prawixina/haraxina/niwya/hararoja/roja/niwa/roja/rojAnA/rojAnA/anuxina/niwyaprawi/anuxivasa/aharaha/hameSA/saxA/niwya/saxEva/niwya_prawi/sarvaxA/sarvaWA/haraxama/haravakwa/harasamaya/xina-rAwa/xinarAwa/xina_rAwa/rAwa-xina/rAwaxina/niSixina/nisa-vAsara/nisavAsara/niSivAsara/niranwara/niranwara/anavaXi/sarvaxEva/aharaha/pinnA/aharniSa/ahorAwra
yUz_hI	akAraNa/prayojanahInawaH/Ese_hI/yUz_hI/kAraNahInawaH/bevajaha/uxxeSyahInawaH/vyarWa_hI/yoM_hI/JUTa-mUTa/yOM_hI/yUz_hI/Ese_hI/nAhaka/nAhaka/PajUla/PajUla/PijUla/PijUla/anahaka/anAhaka
behicaka	nisafkoca/niHsafkoca/nissafkoca/beXadaka/safkocahInawaH/beJiJaka/beKataka/beKatake/behicaka
beXadaka	nisafkoca/niHsafkoca/nissafkoca/beXadaka/safkocahInawaH/beJiJaka/beKataka/beKatake/behicaka
mahaja	akelA/akele/kevala/sirPa/mAwra/KAlI/KAlI/basa/nipata/mahaja/sirPa/wanhA/wanahA/ekAkI/ekameva/ekafga/ikelA
xarakinAra	xarakinAra/xUra/alaga/eka_waraPa/eka_ora/alahaxA
hAWo_hAWa	Jatapata/catapata/PatAPata/wuranwa/wuranwa/wawkAla/avilamba/avilamba/POrana/POrana/KatAka_se/wawkRaNa/wadAka_se/wada_se/wapAka_se/awiSIGra/awiSIGrawaH/jalxa_se_jalxa/jalxI_se_jalxI/wada_se/hAWoM-hAWa/hAWoM_hAWa/hAWo-hAWa/hAWo_hAWa/Kata_se/Anana-PAnana_meM/AnanaPAnana_meM/siwAba/siwAbI/besAKwA/TahAkA/ikahAI/ikahAU
kramavAra	kramaSaH/kramAnusAra/yaWAkrama/silasilevAra/bArI-bArI_se/kramavAra/warawIbavAra/ayugapaxa/alpaSaH
Kulakara	KuleAma/Kulakara/sareAma/sare-Ama/Kule-Ama/Kullama-KullA/KullamaKullA/dafke_kI_cota_para/sare_Ama/agupwawaH
kqwajFawApUrvaka	sABAra/kqwajFawApUrvaka
najaxIka	pAsa_meM/najaxIka/najaxIka/nikata_meM/karIba_meM/samIpa/nikata/pAsa/karIba/karIba/sannikata/najIka/muwwasila/arvAka/avixUra/Are/AsapAsa/Asa-pAsa
sarvawra	cAroM_ora/cAroM_waraPa/cAroM_waraPa/cahuz_ora/sarvawra/saBI_waraPa/cAroM_xiSAoM_meM/hara_jagaha/irxa-girxa
xEvAw	acAnaka/ekAeka/sahasA/ekabAragI/ikabAragI/yakAyaka/akasmAwa/akasmAw/anAyAsa/xEvAw/xEvavaSa/Ocaka/aprawyASiwawaH/ApAwawaH/aFcakEM/agawyA/acaka/acAFcaka/acAkA/acAka/acAna/anAgawaH/anyAsa/nAgahAz/AcAna/ikahAI/ikahAU/iwwiPAkana/iwwiPAkana/iwwaPAkana/iwwaPAkana/ucakA/Ocaka
bASiMxA	niHsanxeha/nissanxeha/jarUra/jarUra/niHsanxeha/nissanxeha/nisanxeha/nisanxeha/binA_Saka/beSaka/bilkula/bilakula/yakInana/yakInana/avaSyameva/avaSya/alabawwA/bilASaka/aBarama/vASiMxA/bASiMxA/avasi/aviwarkika/asaMSaya/niSciwawaH/ikafka
jEse_kA_wEse	jyoM_kA_wyoM/jEse_kA_wEse
anwawogawvA	anwawaH/anwawogawvA/anwa_meM/AKira/AKira/AKirakAra/AKirakAra/howe_havAwe/majabUrana/vivaSawaH/anacAhe/majabUrana/vivaSa_hokara/cAranAcAra/anwawogawvA/barabasa
sareAma	KuleAma/Kulakara/sareAma/sare-Ama/Kule-Ama/Kullama-KullA/KullamaKullA/dafke_kI_cota_para/sare_Ama/agupwawaH
baKUbI	baKUbI/baKUbI
kaxApi	kaxApi/haragija/kawaI/kawwaI
awaeva	isalie/isIlie/awaeva/awaH/lihAjA/lihAjA
sAXAraNawayA	sAmAnyawaH/sAmAnyawayA/sAXAraNawaH/sAXAraNawayA/amUmana/umUmana
jahAz_wahAz	kramahInawaH/akramawaH/avyavasWiwawaH/jahAz_wahAz
yUz	yoM/yUz/Ese/isa_waraha/isa_prakAra/EsA/iwWaM/ima/imi/iBa/iva/isE/IxqS/IxqSa
nisavAsara	hameSA/saxA/niwya/saxEva/niwya_prawi/sarvaxA/sarvaWA/haraxama/haravakwa/harasamaya/xina-rAwa/xinarAwa/xina_rAwa/rAwa-xina/rAwaxina/niSixina/nisa-vAsara/nisavAsara/niSivAsara/niranwara/niranwara/anavaXi/sarvaxEva/aharaha/pinnA/aharniSa/ahorAwra
samBAlakara	sAvaXAnIpUrvaka/XyAnapUrvaka/XyAna_se/sAvaXAnI_se/sAvaXAnawaH/samBAlakara/samBAlakara
saprayojana	prayojanawaH/kAma_se/kAraNa_se/saprayojana
cObArA	cObArA
wIvrawA_se	kasakara/joraxAra/weja/weja/wIvra/wejI_se/jora_se/wejI_se/jora_se/wIvrawA_se
piCale_xinoM_meM	awIwa_meM/pahale/BUwa_meM/BUwa_kAla_meM/pICe/piCale_xinoM_meM
lAparavAhI_se	asAvaXAnawaH/asAvaXAnI_se/XyAnahInawaH/lAparavAhI_se
prawirUpawaH	prawirUpawaH/hUbahU/hU-ba-hU
KuSI_se	prasannawApUrvaka/KuSI_KuSI/KuSI_KuSI/KuSI_se/KuSI_se/prasannawaH/saharRa/harRapUrvaka
dafke_kI_cota_para	KuleAma/Kulakara/sareAma/sare-Ama/Kule-Ama/Kullama-KullA/KullamaKullA/dafke_kI_cota_para/sare_Ama/agupwawaH
nimiRa-mAwra	palaBara/pala-Bara/nimiRa-mAwra/nimeRa-mAwra
samaJa_bUJa_kara	soca-vicArakara/samaJa-bUJakara/vicArapUrvaka/soca-samaJakara/soca_vicAra_kara/samaJa_bUJa_kara/soca_samaJa_kara/vicAriwawaH
icCAnukula	icCAnusAra/icCAnukula/yaWecCa/yaWABIRta/yaWAvAFCiwa
Kullama_KullA	spaRta/spaRtawaH/Kula_kara/Kule_wOra_para/Kullama_KullA/binA_lAga_lapeta_ke/sAPa_sAPa/spaRtawayA/sAPa-sAPa/sAPa-sAPa
beArAma	beArAma
pala-Bara	palaBara/pala-Bara/nimiRa-mAwra/nimeRa-mAwra
kAnUnana	kAnUnana/kAnUnana/viXAnawaH
ananwara	bAxa/bAxa_meM/paScAw/uparAnwa/ananwara/paScAwa/uparAnwa/ananwara/pICe/uwwara/aWa/anupaxa/anvakRa/lagAwAra/anavarawa/niranwara/niranwara/wAbadawoda/xanAxana/sawawa/XUAzXAra/ananwara/ananwara/avirAmawaH/aniSa/prawikRaNa/anukRaNa/XadAXada/avirawa/muwwasila/avicCinna/avicCexa/aviSrAnwa/aviSrAnwa/asarAra/aharaha/Asafga/Asafga/ikawAra
pAsa	pAsa_meM/najaxIka/najaxIka/nikata_meM/karIba_meM/samIpa/nikata/pAsa/karIba/karIba/sannikata/najIka/muwwasila/arvAka/avixUra/Are/AsapAsa/Asa-pAsa/pAsa
karIba	pAsa_meM/najaxIka/najaxIka/nikata_meM/karIba_meM/samIpa/nikata/pAsa/karIba/karIba/sannikata/najIka/muwwasila/arvAka/avixUra/Are/AsapAsa/Asa-pAsa/anxAjana/anxAjana/anxAjana/anxAjana/lagaBaga/wakarIbana/wakarIbana/karIba/karIba/karIbakarIba/karIbana/karIbakarIba/karIbana/anumAnawaH/anakarIba/anakarIba/waKamInana/anxAja_se/ukavAz
uxxeSyahInawaH	uxxeSyahInawaH/niruxxeSya/niruxxeSyawaH/akAraNa/prayojanahInawaH/Ese_hI/yUz_hI/kAraNahInawaH/bevajaha/uxxeSyahInawaH
galawa_vakwa_para	kusamaya/galawa_vakwa_para/asamaya/bevakwa/galawa_vakwa_para/bevakwa/bemOke
bAra_bAra	bAra-bAra/bAra_bAra/bArambAra/bArambAra/asakqwa/ahora-bahora
yoM	yoM/yUz/Ese/isa_waraha/isa_prakAra/EsA/iwWaM/ima/imi/iBa/iva/isE/IxqS/IxqSa
sUkRmawaH	bArIkI_se/bArIkI_se/sUkRmawaH
Ese	yoM/yUz/Ese/isa_waraha/isa_prakAra/EsA/iwWaM/ima/imi/iBa/iva/isE/IxqS/IxqSa
vEsA	vEse/vEsA/usI_waraha/usa_waraha/iva
kaba	kaba_waka/kaba
Aja_waka	aba_waka/aBI_waka/Aja_waka/abawaka/aBIwaka/Ajawaka/ajahuz/ajahUz/ajo/ajOM/abalaga
vEse	vEse/vEsA/usI_waraha/usa_waraha/iva
EsA	yoM/yUz/Ese/isa_waraha/isa_prakAra/EsA/iwWaM/ima/imi/iBa/iva/isE/IxqS/IxqSa
patta	pata/patta/petakEyAz
vicArahInawaH	vicArahInawaH/anasoce/besoce_samaJe
TIka-TAka_se	sakuSala/kuSalawApUrvaka/kuSalapUrvaka/sahI_salAmawa/sahI-salAmawa/TIka-TAka/TIka_se/TIka-TAka_se/TIkaTAka/baKEra/baKEra/baKErIya/baKErIyawa/surakRiwawaH
aba_kI	aba/abakI/isabAra/aba_kI/isa_bAra
warakIba_se	yukwipUrvaka/upAyawaH/upAya_se/jugawa_lagAkara/warakIba_se/warIke_se
ihAz	yahAz/isa_jagaha/iwaH/iwa/iha/ihAz/ihavAz/IMGe/IhAz
KAsakara	viSeRakara/KAsakara/KAsa_wOra_para/KAsa_wOra_se/KAsawOra_para/KAsawOra_se/KAsawOra_para/KAsawOra_se/KAsakara/viSeRawaH/viSiRtawaH/muKyawaH/viSeRa_rUpa_se
BalI_BAnwi	BalI-BAzwi/BalI_BAzwi/BarapUra/BalIBAzwi/BalI-BAnwi/BalI_BAnwi/BalIBAnwi/sarvawoBAva/acCI_waraha
jalxI_se	jalxI/SIGra/SIGrawaH/avilambawaH/jalxa/acira/wUrNa/SiwAba/begi/avalambiwa/avalambiwa/jalxI_se/ASu/avilambiwa/avilambiwa
uxxeSyapUrvaka	uxxeSyapUrvaka/uxxeSyawaH/sABiprAyaH/soxxeSya
acAFcaka	acAnaka/ekAeka/sahasA/ekabAragI/ikabAragI/yakAyaka/akasmAwa/akasmAw/anAyAsa/xEvAw/xEvavaSa/Ocaka/aprawyASiwawaH/ApAwawaH/aFcakEM/agawyA/acaka/acAFcaka/acAkA/acAka/acAna/anAgawaH/anyAsa/nAgahAz/AcAna/ikahAI/ikahAU/iwwiPAkana/iwwiPAkana/iwwaPAkana/iwwaPAkana/ucakA/Ocaka
kahAz	kahAz
sAXikAra	aXikArapUrvaka/sAXikAra/aXikArawaH
TIka	bilkula/bilakula/ekaxama/nipata/sarAsara/TIka/niwAnwa/niwAnwa/pUrNawaH/pUrI_waraha_se/pUrNawayA/sampUrNawaH/sampUrNawayA/pUrNarupeNa/AmUlacUla/Sawa-prawiSawa/TIka-TAka/TIkaTAka/TIka/acCA/baDiyA/TIka/TIka_se/acCI_waraha/acCI_waraha_se
ruka-ruka_kara	ruka-ruka_kara/ruka-rukakara/virAmawaH/Tahara_Tahara_kara/savirAmawaH
KAsa_wOra_se	viSeRakara/KAsakara/KAsa_wOra_para/KAsa_wOra_se/KAsawOra_para/KAsawOra_se/KAsawOra_para/KAsawOra_se/KAsakara/viSeRawaH/viSiRtawaH/muKyawaH/viSeRa_rUpa_se
asAlawana	svayaM/svawaH/Kuxa/Kuxa/Apa/ApahI/apaneApa/Kuxa_hI/sAkRAw/sAkRAwa/asAlawana/AparUpa
wIna_gunA	wigunA/wInagunA/wIna_gunA
kamabeSa	kamobeSa/kamabeSa/nyUnAXika
waba_hI	waBI/waba_hI/usI_samaya/usI_GadI
xobArA	xubArA/xobArA/Pira/Pira_se/punaH/eka_bAra_Pira/vApasa_se
niSSabxa	cupacApa/cupa/mOna/SAnwa/SAnwa/KAmoSI_se/KAmoSI_se/niSSabxa/avAka/avAk/bina_bole/mOnawaH
sAyAsa	prayawnapUrvaka/sAyAsa/prayawnawaH/prayawna_se
sarvaxA	hameSA/saxA/niwya/saxEva/niwya_prawi/sarvaxA/sarvaWA/haraxama/haravakwa/harasamaya/xina-rAwa/xinarAwa/xina_rAwa/rAwa-xina/rAwaxina/niSixina/nisa-vAsara/nisavAsara/niSivAsara/niranwara/niranwara/anavaXi/sarvaxEva/aharaha/pinnA/aharniSa/ahorAwra
Age_pICe	AgepICe/Age_pICe/Age-pICe/pUrvApara
burI_waraha	burA/KarAba/burI_waraha
sAwagunA	sAwagunA/sawagunA
ahewu	vyarWa/PajUla/PijUla/PijUla/anerA/yoM_hI/vqWA/apArWa/bAxa-havAI/bAxahavAI/ahewu/ahewuka/aviraWA
bAyeM	bAez/bAez_bAjU/bAyeM
praWamawaH	pahale_pahala/praWamawaH/sarva_praWama/sarvapraWama/SurU_meM/pahale-pahala/avvalana/pahile_pahala/pahile_pahala/AramBa_meM/AramBawaH/AramBawaH/pahale/SurU_meM/praWama/Axi_meM/praWamawaH/sarvapraWama/pUrva/SuruAwa_meM/SuruvAwa_meM/AramBa_meM/prAramBa_meM
viSeRa_rUpa_se	viSeRakara/KAsakara/KAsa_wOra_para/KAsa_wOra_se/KAsawOra_para/KAsawOra_se/KAsawOra_para/KAsawOra_se/KAsakara/viSeRawaH/viSiRtawaH/muKyawaH/viSeRa_rUpa_se
uwa	uXara/usa_ora/pare/uwa/uwana
upAya_se	yukwipUrvaka/upAyawaH/upAya_se/jugawa_lagAkara/warakIba_se/warIke_se
karmAnusAra	yaWAkarma/karmAnusAra
svecCawaH	svecCApUrvaka/icCA_se/KuSI_KuSI/KuSI_se/svecCayA/svecCawaH
usa_vakwa	waba/usa_samaya/usa_vakwa
prawikRaNa	lagAwAra/anavarawa/niranwara/niranwara/wAbadawoda/xanAxana/sawawa/XUAzXAra/ananwara/ananwara/avirAmawaH/aniSa/prawikRaNa/anukRaNa/XadAXada/avirawa/muwwasila/avicCinna/avicCexa/aviSrAnwa/aviSrAnwa/asarAra/aharaha/Asafga/Asafga/ikawAra/prawikRaNa/pala_pala/pala-pala/prawipala/hara_kRaNa/kRaNa-kRaNa/haraGadI/hara_GadI/prawi_kRaNa/kRaNakRaNa/anukRaNa/CinaCina/Cina-Cina/AKana
AjFAnusAra	AjFAnusAra/AxeSAnusAra
haraGadI	prawikRaNa/pala_pala/pala-pala/prawipala/hara_kRaNa/kRaNa-kRaNa/haraGadI/hara_GadI/prawi_kRaNa/kRaNakRaNa/anukRaNa/CinaCina/Cina-Cina/AKana
paScAwa	bAxa/bAxa_meM/paScAw/uparAnwa/ananwara/paScAwa/uparAnwa/ananwara/pICe/uwwara/aWa/anupaxa/anvakRa
xviguNa	xugunA/xUnA/xogunA/xuganA/xviguNa/xviguNiwa
bina_bole	cupacApa/cupa/mOna/SAnwa/SAnwa/KAmoSI_se/KAmoSI_se/niSSabxa/avAka/avAk/bina_bole/mOnawaH
animiKa	takatakI_se/ekataka/tukura_tukura/taka-taka/animeRa/animiRa/animiKa/anamiKa/ikataka
hiwArWa	hiwArWa/kalyANArWa
prAyaSaH	prAyaH/akasara/aksara/aXikawara/aXikAMSawaH/jyAxAwara/bahuXA/AmawOra_para/AmawOra_se/aXikAMSawayA/prAyaSaH/anekaXA
sarvawoBAva	BalI-BAzwi/BalI_BAzwi/BarapUra/BalIBAzwi/BalI-BAnwi/BalI_BAnwi/BalIBAnwi/sarvawoBAva/acCI_waraha
aba	PilahAla/PilahAla/aba/varwamAna_meM/Aja-kala/Ajakala/Aja_kala/AjakAla/ina_xinoM/isa_samaya/samprawi/aBI/PilahAla/PilahAla/isa_samaya/aba/aWa/aXunA/samprawi/samprawi/aBU/aBE/aba/abakI/isabAra/aba_kI/isa_bAra/aba/Age/AiMxA/AiMxA/AyanxA/AyanxA/aba
bAsaUra	SiRtawaH/saByawaH/bAsaUra/SAlInawaH/SiRtAcArapUrvaka/salIke_se
binA_lAga_lapeta_ke	spaRta/spaRtawaH/Kula_kara/Kule_wOra_para/Kullama_KullA/binA_lAga_lapeta_ke/sAPa_sAPa/spaRtawayA/sAPa-sAPa/sAPa-sAPa
lagAwAra	lagAwAra/anavarawa/niranwara/niranwara/wAbadawoda/xanAxana/sawawa/XUAzXAra/ananwara/ananwara/avirAmawaH/aniSa/prawikRaNa/anukRaNa/XadAXada/avirawa/muwwasila/avicCinna/avicCexa/aviSrAnwa/aviSrAnwa/asarAra/aharaha/Asafga/Asafga/ikawAra
prasannawaH	prasannawApUrvaka/KuSI_KuSI/KuSI_KuSI/KuSI_se/KuSI_se/prasannawaH/saharRa/harRapUrvaka
nAmamAwra	nAmamAwra/leSamAwra/raFcamAwra/WodA_sA
bawOra	viXipUrvaka/kAyaxe_se/Dafga_se/warIke_se/bawOra/bAkAyaxA/viXivaw/viXivawa
kAlAnwara_meM	kAlAnwara_meM
anyawra	anyawra/kahIM_Ora/anawa
ajahuz	aba_waka/aBI_waka/Aja_waka/abawaka/aBIwaka/Ajawaka/ajahuz/ajahUz/ajo/ajOM/abalaga
avasi	niHsanxeha/nissanxeha/jarUra/jarUra/niHsanxeha/nissanxeha/nisanxeha/nisanxeha/binA_Saka/beSaka/bilkula/bilakula/yakInana/yakInana/avaSyameva/avaSya/alabawwA/bilASaka/aBarama/vASiMxA/bASiMxA/avasi/aviwarkika/asaMSaya/niSciwawaH/ikafka
baKUbI	baKUbI/baKUbI
isa_bAra	aba/abakI/isabAra/aba_kI/isa_bAra
IrRyApUrNawaH	IrRyApUrvaka/IrRyawaH/xveRapUrvaka/sAsUya/IrRyApUrNawaH
anaXikAra	anaXikAra/aXikArahInawaH
xveRapUrvaka	IrRyApUrvaka/IrRyawaH/xveRapUrvaka/sAsUya/IrRyApUrNawaH
iBa	yoM/yUz/Ese/isa_waraha/isa_prakAra/EsA/iwWaM/ima/imi/iBa/iva/isE/IxqS/IxqSa
saMyogavaSAw	saMyogavaSa/iwwiPAkana/iwwiPAkana/iwwaPAkana/iwwaPAkana/saMyogavaSAw
pUrvApara	AgepICe/Age_pICe/Age-pICe/pUrvApara
niwya_prawi	hameSA/saxA/niwya/saxEva/niwya_prawi/sarvaxA/sarvaWA/haraxama/haravakwa/harasamaya/xina-rAwa/xinarAwa/xina_rAwa/rAwa-xina/rAwaxina/niSixina/nisa-vAsara/nisavAsara/niSivAsara/niranwara/niranwara/anavaXi/sarvaxEva/aharaha/pinnA/aharniSa/ahorAwra
umraBara	mqwyuparyanwa/AjIvana/wAumra/umraBara/jiMxagIBara/jiMxagIBara/jIvanaBara/AmaraNa/anwima_xama_waka
KAsawOra_para	viSeRakara/KAsakara/KAsa_wOra_para/KAsa_wOra_se/KAsawOra_para/KAsawOra_se/KAsawOra_para/KAsawOra_se/KAsakara/viSeRawaH/viSiRtawaH/muKyawaH/viSeRa_rUpa_se
pAra	pAra/xUsarI_waraPa
Apasa_meM	paraspara/Apasa_meM/eka_xUsare_se/iwarewara
lOtAnI	lOtAnI
nisa-vAsara	hameSA/saxA/niwya/saxEva/niwya_prawi/sarvaxA/sarvaWA/haraxama/haravakwa/harasamaya/xina-rAwa/xinarAwa/xina_rAwa/rAwa-xina/rAwaxina/niSixina/nisa-vAsara/nisavAsara/niSivAsara/niranwara/niranwara/anavaXi/sarvaxEva/aharaha/pinnA/aharniSa/ahorAwra
rAwoMrAwa	rAwoM-rAwa/rAwoMrAwa
niranwara	lagAwAra/anavarawa/niranwara/niranwara/wAbadawoda/xanAxana/sawawa/XUAzXAra/ananwara/ananwara/avirAmawaH/aniSa/prawikRaNa/anukRaNa/XadAXada/avirawa/muwwasila/avicCinna/avicCexa/aviSrAnwa/aviSrAnwa/asarAra/aharaha/Asafga/Asafga/ikawAra/hameSA/saxA/niwya/saxEva/niwya_prawi/sarvaxA/sarvaWA/haraxama/haravakwa/harasamaya/xina-rAwa/xinarAwa/xina_rAwa/rAwa-xina/rAwaxina/niSixina/nisa-vAsara/nisavAsara/niSivAsara/niranwara/niranwara/anavaXi/sarvaxEva/aharaha/pinnA/aharniSa/ahorAwra
ikajora	sAWa-sAWa/sAWa_hI/sAWa_hI_sAWa/sAWa/eka_sAWa/ikatTA/ikajora/ekawra/ikawra
vqWA	vyarWa/PajUla/PijUla/PijUla/anerA/yoM_hI/vqWA/apArWa/bAxa-havAI/bAxahavAI/ahewu/ahewuka/aviraWA
yawkiMciw	jarA/jarA/jarA-sA/jarA-sA/rawwiBara/WodA/WodA-sA/WodA_sA/wanika/yawkiMciw
KatAka_se	Jatapata/catapata/PatAPata/wuranwa/wuranwa/wawkAla/avilamba/avilamba/POrana/POrana/KatAka_se/wawkRaNa/wadAka_se/wada_se/wapAka_se/awiSIGra/awiSIGrawaH/jalxa_se_jalxa/jalxI_se_jalxI/wada_se/hAWoM-hAWa/hAWoM_hAWa/hAWo-hAWa/hAWo_hAWa/Kata_se/Anana-PAnana_meM/AnanaPAnana_meM/siwAba/siwAbI/besAKwA/TahAkA/ikahAI/ikahAU
parasoM	parasoM/parasoM
ikawra	sAWa-sAWa/sAWa_hI/sAWa_hI_sAWa/sAWa/eka_sAWa/ikatTA/ikajora/ekawra/ikawra
KUba	bahuwa/KUba/KUba/badA/jyAxA/jyAxA/aXika/kAPI/kAPI/kadA/jamakara/datakara
najaxIka	pAsa_meM/najaxIka/najaxIka/nikata_meM/karIba_meM/samIpa/nikata/pAsa/karIba/karIba/sannikata/najIka/muwwasila/arvAka/avixUra/Are/AsapAsa/Asa-pAsa
uxArawApUrvaka	uxArawApUrvaka
kuSalawApUrvaka	sakuSala/kuSalawApUrvaka/kuSalapUrvaka/sahI_salAmawa/sahI-salAmawa/TIka-TAka/TIka_se/TIka-TAka_se/TIkaTAka/baKEra/baKEra/baKErIya/baKErIyawa/surakRiwawaH
bagEra	binA/bagEra/bagEra
cupacApa	cupacApa/cupa/mOna/SAnwa/SAnwa/KAmoSI_se/KAmoSI_se/niSSabxa/avAka/avAk/bina_bole/mOnawaH
jyoM-jyoM	jEse-jEse/jyoM-jyoM
sAPa-sAPa	spaRta/spaRtawaH/Kula_kara/Kule_wOra_para/Kullama_KullA/binA_lAga_lapeta_ke/sAPa_sAPa/spaRtawayA/sAPa-sAPa/sAPa-sAPa
sacamuca	vAkaI/vAkaI/vAswava_meM/hakIkawana/hakIkawana/xaraasala/asala_meM/sacamuca/saccI-muccI/saccI_muccI/sawyawaH/vaswuwaH
safkalpapUrvaka	safkalpapUrvaka/irAxawana/irAxe_se/xqDawApUrvaka/niScayapUrvaka
BalI-BAnwi	BalI-BAzwi/BalI_BAzwi/BarapUra/BalIBAzwi/BalI-BAnwi/BalI_BAnwi/BalIBAnwi/sarvawoBAva/acCI_waraha
AmUlacUla	bilkula/bilakula/ekaxama/nipata/sarAsara/TIka/niwAnwa/niwAnwa/pUrNawaH/pUrI_waraha_se/pUrNawayA/sampUrNawaH/sampUrNawayA/pUrNarupeNa/AmUlacUla/Sawa-prawiSawa
prayojanahInawaH	akAraNa/prayojanahInawaH/Ese_hI/yUz_hI/kAraNahInawaH/bevajaha/uxxeSyahInawaH
rimaJima-rimaJima	rimaJima/rimaJima-rimaJima/rima-Jima
anahaka	vyarWa_hI/yoM_hI/JUTa-mUTa/yOM_hI/yUz_hI/Ese_hI/nAhaka/nAhaka/PajUla/PajUla/PijUla/PijUla/anahaka/anAhaka
SiwAba	jalxI/SIGra/SIGrawaH/avilambawaH/jalxa/acira/wUrNa/SiwAba/begi/avalambiwa/avalambiwa/jalxI_se/ASu/avilambiwa/avilambiwa
rAwaxina	hameSA/saxA/niwya/saxEva/niwya_prawi/sarvaxA/sarvaWA/haraxama/haravakwa/harasamaya/xina-rAwa/xinarAwa/xina_rAwa/rAwa-xina/rAwaxina/niSixina/nisa-vAsara/nisavAsara/niSivAsara/niranwara/niranwara/anavaXi/sarvaxEva/aharaha/pinnA/aharniSa/ahorAwra
Ajanma	Ajanma/jIvanaparyanwa/jIvanaBara
gumasuma	gumasuma
aXikAMSawaH	aXikawaH/aXikAMSawaH/prAyaH/aXikAMSawayA/prAyaH/akasara/aksara/aXikawara/aXikAMSawaH/jyAxAwara/bahuXA/AmawOra_para/AmawOra_se/aXikAMSawayA/prAyaSaH/anekaXA
nirnimeRa	apalaka/nirnimeRa/nirnimiRa/nirnimeKa
muSkila_se	kaTinAI_se/jEse_wEse/muSkila_se/bamuSkila/kaTinawaH/nITi
Upara	Upara/Upara/UzcAI_para/UrxXva/UrXva/Upara/AXAra_para/Upara/aXika/jyAxA/jyAxA/Upara_se/Upara/Upara
baKEra	sakuSala/kuSalawApUrvaka/kuSalapUrvaka/sahI_salAmawa/sahI-salAmawa/TIka-TAka/TIka_se/TIka-TAka_se/TIkaTAka/baKEra/baKEra/baKErIya/baKErIyawa/surakRiwawaH
AmawOra_para	prAyaH/akasara/aksara/aXikawara/aXikAMSawaH/jyAxAwara/bahuXA/AmawOra_para/AmawOra_se/aXikAMSawayA/prAyaSaH/anekaXA
viXihInawaH	viXihInawaH/kuviXipUrvaka/bewarIke
niSixina	hameSA/saxA/niwya/saxEva/niwya_prawi/sarvaxA/sarvaWA/haraxama/haravakwa/harasamaya/xina-rAwa/xinarAwa/xina_rAwa/rAwa-xina/rAwaxina/niSixina/nisa-vAsara/nisavAsara/niSivAsara/niranwara/niranwara/anavaXi/sarvaxEva/aharaha/pinnA/aharniSa/ahorAwra
AxyAnwa	AxyopAnwa/AxyopAnwa/AxyAnwa/AxyAnwa
KAmoSI_se	cupacApa/cupa/mOna/SAnwa/SAnwa/KAmoSI_se/KAmoSI_se/niSSabxa/avAka/avAk/bina_bole/mOnawaH
BaviRya_kAla_meM	BaviRya_meM/Age/BaviRya_kAla_meM/agawyA
nArAjagIpUrvaka	aprasannawApUrvaka/nArAjagIpUrvaka/nAKuSI_se/nArAjagIpUrvaka/nAKuSI_se
Aja-kala	PilahAla/PilahAla/aba/varwamAna_meM/Aja-kala/Ajakala/Aja_kala/AjakAla/ina_xinoM/isa_samaya/samprawi
acAna	acAnaka/ekAeka/sahasA/ekabAragI/ikabAragI/yakAyaka/akasmAwa/akasmAw/anAyAsa/xEvAw/xEvavaSa/Ocaka/aprawyASiwawaH/ApAwawaH/aFcakEM/agawyA/acaka/acAFcaka/acAkA/acAka/acAna/anAgawaH/anyAsa/nAgahAz/AcAna/ikahAI/ikahAU/iwwiPAkana/iwwiPAkana/iwwaPAkana/iwwaPAkana/ucakA/Ocaka
bArambAra	bAra-bAra/bAra_bAra/bArambAra/bArambAra/asakqwa/ahora-bahora
hU-ba-hU	prawirUpawaH/hUbahU/hU-ba-hU
baDiyA	TIka-TAka/TIkaTAka/TIka/acCA/baDiyA/acCA/baDiyA/acCI_waraha/acCI_waraha_se/tanAtana
prawixina	prawixina/haraxina/niwya/hararoja/roja/niwa/roja/rojAnA/rojAnA/anuxina/niwyaprawi/anuxivasa/aharaha
COgunA	CahagunA/COgunA/CaHgunA
kisa_prakAra_se	kEse/kisa_prakAra_se
aXikArawaH	aXikArapUrvaka/sAXikAra/aXikArawaH
yaWAvaw	yaWAvaw/yaWAvawa
yahAz	yahAz/isa_jagaha/iwaH/iwa/iha/ihAz/ihavAz/IMGe/IhAz
cupake_se	cupake_se/cupake-cupake/xaraparaxA
Upara_se	Upara_se/Upara
jEse-wEse	jEse-wEse
anAgawaH	acAnaka/ekAeka/sahasA/ekabAragI/ikabAragI/yakAyaka/akasmAwa/akasmAw/anAyAsa/xEvAw/xEvavaSa/Ocaka/aprawyASiwawaH/ApAwawaH/aFcakEM/agawyA/acaka/acAFcaka/acAkA/acAka/acAna/anAgawaH/anyAsa/nAgahAz/AcAna/ikahAI/ikahAU/iwwiPAkana/iwwiPAkana/iwwaPAkana/iwwaPAkana/ucakA/Ocaka
surakRiwawaH	sakuSala/kuSalawApUrvaka/kuSalapUrvaka/sahI_salAmawa/sahI-salAmawa/TIka-TAka/TIka_se/TIka-TAka_se/TIkaTAka/baKEra/baKEra/baKErIya/baKErIyawa/surakRiwawaH
bAxa-havAI	vyarWa/PajUla/PijUla/PijUla/anerA/yoM_hI/vqWA/apArWa/bAxa-havAI/bAxahavAI/ahewu/ahewuka/aviraWA
basa	basa/alam/alaM/akelA/akele/kevala/sirPa/mAwra/KAlI/KAlI/basa/nipata/mahaja/sirPa/wanhA/wanahA/ekAkI/ekameva/ekafga/ikelA
aso	aso/asoM/AsO/isa_varRa/isa_sAla
aXimAnawaH	aXimAnawaH/varIyawA_se/acCA_ho_ki
bemawalaba	akAraNa/bemawalaba/niRkAraNa/kAraNahInawaH/animiwwa
uBayawaH	uBayawaH
samAnAnwara	samAnwara/samAnAnwara/samAnwara/samAnAnwara
cupa	cupacApa/cupa/mOna/SAnwa/SAnwa/KAmoSI_se/KAmoSI_se/niSSabxa/avAka/avAk/bina_bole/mOnawaH
POrana	Jatapata/catapata/PatAPata/wuranwa/wuranwa/wawkAla/avilamba/avilamba/POrana/POrana/KatAka_se/wawkRaNa/wadAka_se/wada_se/wapAka_se/awiSIGra/awiSIGrawaH/jalxa_se_jalxa/jalxI_se_jalxI/wada_se/hAWoM-hAWa/hAWoM_hAWa/hAWo-hAWa/hAWo_hAWa/Kata_se/Anana-PAnana_meM/AnanaPAnana_meM/siwAba/siwAbI/besAKwA/TahAkA/ikahAI/ikahAU
wawkAla	Jatapata/catapata/PatAPata/wuranwa/wuranwa/wawkAla/avilamba/avilamba/POrana/POrana/KatAka_se/wawkRaNa/wadAka_se/wada_se/wapAka_se/awiSIGra/awiSIGrawaH/jalxa_se_jalxa/jalxI_se_jalxI/wada_se/hAWoM-hAWa/hAWoM_hAWa/hAWo-hAWa/hAWo_hAWa/Kata_se/Anana-PAnana_meM/AnanaPAnana_meM/siwAba/siwAbI/besAKwA/TahAkA/ikahAI/ikahAU
isa_ora	iXara/isa_ora/yahAz_para/iwaH/iwa/iwE/iwWe
anvakRa	sAmane/Age/samakRa/sammuKa/agre/anvakRa/aBimuKa/xarapeSa/Agala/AgalA/bAxa/bAxa_meM/paScAw/uparAnwa/ananwara/paScAwa/uparAnwa/ananwara/pICe/uwwara/aWa/anupaxa/anvakRa
axya	Aja/axya
kRaNakRaNa	prawikRaNa/pala_pala/pala-pala/prawipala/hara_kRaNa/kRaNa-kRaNa/haraGadI/hara_GadI/prawi_kRaNa/kRaNakRaNa/anukRaNa/CinaCina/Cina-Cina/AKana
Kula_kara	spaRta/spaRtawaH/Kula_kara/Kule_wOra_para/Kullama_KullA/binA_lAga_lapeta_ke/sAPa_sAPa/spaRtawayA/sAPa-sAPa/sAPa-sAPa
jarA-sA	jarA/jarA/jarA-sA/jarA-sA/rawwiBara/WodA/WodA-sA/WodA_sA/wanika/yawkiMciw
pare	uXara/usa_ora/pare/uwa/uwana/xUra/xUrI_para/alaga/pare/pare/Age/bAxa/pare
saharRa	prasannawApUrvaka/KuSI_KuSI/KuSI_KuSI/KuSI_se/KuSI_se/prasannawaH/saharRa/harRapUrvaka
jarUra	niHsanxeha/nissanxeha/jarUra/jarUra/niHsanxeha/nissanxeha/nisanxeha/nisanxeha/binA_Saka/beSaka/bilkula/bilakula/yakInana/yakInana/avaSyameva/avaSya/alabawwA/bilASaka/aBarama/vASiMxA/bASiMxA/avasi/aviwarkika/asaMSaya/niSciwawaH/ikafka/avaSya/jarUra/jarUra
Tahara_Tahara_kara	ruka-ruka_kara/ruka-rukakara/virAmawaH/Tahara_Tahara_kara/savirAmawaH
usa_samaya	waba/usa_samaya/usa_vakwa
yaWAkRama	yaWASakwi/Barasaka/yaWAsAXya/yaWAsamBava/kRamawAnusAra/yaWAkRama
niruxxeSya	uxxeSyahInawaH/niruxxeSya/niruxxeSyawaH
samayAnusAra	samayAnusAra/yaWAsamaya/sasamaya
usa_waraha	vEse/vEsA/usI_waraha/usa_waraha/iva
isa_xOrAna	iwane_meM/isa_bIca/isI_bIca/isa_xOrAna/isa_xaramyAna
saSarIra	saxeha/saSarIra
IrRyawaH	IrRyApUrvaka/IrRyawaH/xveRapUrvaka/sAsUya/IrRyApUrNawaH
WodA	jarA/jarA/jarA-sA/jarA-sA/rawwiBara/WodA/WodA-sA/WodA_sA/wanika/yawkiMciw
hararoja	prawixina/haraxina/niwya/hararoja/roja/niwa/roja/rojAnA/rojAnA/anuxina/niwyaprawi/anuxivasa/aharaha
ekawra	sAWa-sAWa/sAWa_hI/sAWa_hI_sAWa/sAWa/eka_sAWa/ikatTA/ikajora/ekawra/ikawra
jarUra	niHsanxeha/nissanxeha/jarUra/jarUra/niHsanxeha/nissanxeha/nisanxeha/nisanxeha/binA_Saka/beSaka/bilkula/bilakula/yakInana/yakInana/avaSyameva/avaSya/alabawwA/bilASaka/aBarama/vASiMxA/bASiMxA/avasi/aviwarkika/asaMSaya/niSciwawaH/ikafka/avaSya/jarUra/jarUra
Osawana	Osawana
sAwafka	AwafkapUrvaka/sAwafka
aksara	prAyaH/akasara/aksara/aXikawara/aXikAMSawaH/jyAxAwara/bahuXA/AmawOra_para/AmawOra_se/aXikAMSawayA/prAyaSaH/anekaXA
Aja	Aja/axya
cUdAnwa	awyanwa/awyanwa/awyaXika/be-iMwahA/beiMwahA/bahuwa_aXika/bahuwa_hI/bepanAha/saKwa/saKwa/jamakara/mahA/nihAyawa/cUdAnwa/cUdAnwa/aByaXika/Agara
vakAlawana	vakAlawana
xUsarI_waraPa	pAra/xUsarI_waraPa
kAyaxe_se	viXipUrvaka/kAyaxe_se/Dafga_se/warIke_se/bawOra/bAkAyaxA/viXivaw/viXivawa
isa_jagaha	yahAz/isa_jagaha/iwaH/iwa/iha/ihAz/ihavAz/IMGe/IhAz
uparAnwa	bAxa/bAxa_meM/paScAw/uparAnwa/ananwara/paScAwa/uparAnwa/ananwara/pICe/uwwara/aWa/anupaxa/anvakRa
alpaSaH	alpawaH/WodA-WodA/WodA_WodA/alpaSaH/kramaSaH/kramAnusAra/yaWAkrama/silasilevAra/bArI-bArI_se/kramavAra/warawIbavAra/ayugapaxa/alpaSaH/XIre-XIre/XIre_XIre/Ahiswe-Ahiswe/AhiswA-AhiswA/hOle-hOle/hole-hole/raPwA-raPwA/alpaSaH
yaWAsamaya	samayAnusAra/yaWAsamaya/sasamaya
galawa_vakwa_para	kusamaya/galawa_vakwa_para/asamaya/bevakwa/galawa_vakwa_para/bevakwa/bemOke
anXaXunXa	anXAXunXa/bewahASA/anXAXunXa/anXaXunXa/anXaXunXa/utakkara
kisalie	kyoM/kisalie/kisa_vAswe
SAnwa	cupacApa/cupa/mOna/SAnwa/SAnwa/KAmoSI_se/KAmoSI_se/niSSabxa/avAka/avAk/bina_bole/mOnawaH
syaw	samBavawaH/SAyaxa/syaw
KuSI_KuSI	svecCApUrvaka/icCA_se/KuSI_KuSI/KuSI_se/svecCayA/svecCawaH/prasannawApUrvaka/KuSI_KuSI/KuSI_KuSI/KuSI_se/KuSI_se/prasannawaH/saharRa/harRapUrvaka
krUrawApUrvaka	nirxayawApUrvaka/nirxayawA_se/berahamI_se/bexarxI_se/krUrawApUrvaka/barbarawApUrvaka/kaTorawA_se/kadAI_se
vApasa	vApasa/vApisa
sarvapraWama	pahale_pahala/praWamawaH/sarva_praWama/sarvapraWama/SurU_meM/pahale-pahala/avvalana/pahile_pahala/pahile_pahala/AramBa_meM/AramBawaH/AramBawaH/pahale/SurU_meM/praWama/Axi_meM/praWamawaH/sarvapraWama/pUrva/SuruAwa_meM/SuruvAwa_meM/AramBa_meM/prAramBa_meM
spaRta	spaRta/spaRtawaH/Kula_kara/Kule_wOra_para/Kullama_KullA/binA_lAga_lapeta_ke/sAPa_sAPa/spaRtawayA/sAPa-sAPa/sAPa-sAPa
anawa	anyawra/kahIM_Ora/anawa
ikafka	niHsanxeha/nissanxeha/jarUra/jarUra/niHsanxeha/nissanxeha/nisanxeha/nisanxeha/binA_Saka/beSaka/bilkula/bilakula/yakInana/yakInana/avaSyameva/avaSya/alabawwA/bilASaka/aBarama/vASiMxA/bASiMxA/avasi/aviwarkika/asaMSaya/niSciwawaH/ikafka
hasbe-mAmUla	hasbemAmUla/hasbe-mAmUla/hasba-e-mAmUla/hameSA_kI_waraha
kahUz	kahIM/kahUz/kahuz/kahIM/kahUz/kahuz
Cinna-Binna	wiwara-biwara/aswa-vyaswa/Cinna-Binna/bewarawIba/aswavyaswa/_avyavasWiwa
jarA	jarA/jarA/jarA-sA/jarA-sA/rawwiBara/WodA/WodA-sA/WodA_sA/wanika/yawkiMciw
samakRa	sAmane/Age/samakRa/sammuKa/agre/anvakRa/aBimuKa/xarapeSa/Agala/AgalA
niSciMwawaH	niSciMwawaH/ciMwAhInawaH/beKatake
avilambiwa	jalxI/SIGra/SIGrawaH/avilambawaH/jalxa/acira/wUrNa/SiwAba/begi/avalambiwa/avalambiwa/jalxI_se/ASu/avilambiwa/avilambiwa
KAmoSI_se	cupacApa/cupa/mOna/SAnwa/SAnwa/KAmoSI_se/KAmoSI_se/niSSabxa/avAka/avAk/bina_bole/mOnawaH
hAWa_xvArA	hAWa_se/hAWa_xvArA/haswacAliwa_Dafga_se/haswacAlana_xvArA
binA_pariSrama	anAyAsa/binA_pariSrama/aprayawnawaH/prayawnahInawaH/ayAsa
bagaCuta	bagaCuta/bagatuta
yaWAparAXa	yaWAparAXa/aparAXAnusAra
kasakara	kasakara/joraxAra/weja/weja/wIvra/wejI_se/jora_se/wejI_se/jora_se/wIvrawA_se
ApAwawaH	acAnaka/ekAeka/sahasA/ekabAragI/ikabAragI/yakAyaka/akasmAwa/akasmAw/anAyAsa/xEvAw/xEvavaSa/Ocaka/aprawyASiwawaH/ApAwawaH/aFcakEM/agawyA/acaka/acAFcaka/acAkA/acAka/acAna/anAgawaH/anyAsa/nAgahAz/AcAna/ikahAI/ikahAU/iwwiPAkana/iwwiPAkana/iwwaPAkana/iwwaPAkana/ucakA/Ocaka
vahAz	vahAz/usa_jagaha
BUwa_meM	awIwa_meM/pahale/BUwa_meM/BUwa_kAla_meM/pICe/piCale_xinoM_meM
wAumra	mqwyuparyanwa/AjIvana/wAumra/umraBara/jiMxagIBara/jiMxagIBara/jIvanaBara/AmaraNa/anwima_xama_waka
haravakwa	hameSA/saxA/niwya/saxEva/niwya_prawi/sarvaxA/sarvaWA/haraxama/haravakwa/harasamaya/xina-rAwa/xinarAwa/xina_rAwa/rAwa-xina/rAwaxina/niSixina/nisa-vAsara/nisavAsara/niSivAsara/niranwara/niranwara/anavaXi/sarvaxEva/aharaha/pinnA/aharniSa/ahorAwra
xaSa_gunA	xasagunA/xaSagunA/xasa_gunA/xaSa_gunA
kaBIkaBI	kaBIkaBI/kaBIkaBAra/yaxAkaxA/kaBI-kaBI/kaBI-kaBAra/yaxA-kaxA/vakwan-POvakwan
WodA-sA	jarA/jarA/jarA-sA/jarA-sA/rawwiBara/WodA/WodA-sA/WodA_sA/wanika/yawkiMciw
awyanwa	awyanwa/awyanwa/awyaXika/be-iMwahA/beiMwahA/bahuwa_aXika/bahuwa_hI/bepanAha/saKwa/saKwa/jamakara/mahA/nihAyawa/cUdAnwa/cUdAnwa/aByaXika/Agara
asoM	aso/asoM/AsO/isa_varRa/isa_sAla
akasmAw	acAnaka/ekAeka/sahasA/ekabAragI/ikabAragI/yakAyaka/akasmAwa/akasmAw/anAyAsa/xEvAw/xEvavaSa/Ocaka/aprawyASiwawaH/ApAwawaH/aFcakEM/agawyA/acaka/acAFcaka/acAkA/acAka/acAna/anAgawaH/anyAsa/nAgahAz/AcAna/ikahAI/ikahAU/iwwiPAkana/iwwiPAkana/iwwaPAkana/iwwaPAkana/ucakA/Ocaka
avilamba	Jatapata/catapata/PatAPata/wuranwa/wuranwa/wawkAla/avilamba/avilamba/POrana/POrana/KatAka_se/wawkRaNa/wadAka_se/wada_se/wapAka_se/awiSIGra/awiSIGrawaH/jalxa_se_jalxa/jalxI_se_jalxI/wada_se/hAWoM-hAWa/hAWoM_hAWa/hAWo-hAWa/hAWo_hAWa/Kata_se/Anana-PAnana_meM/AnanaPAnana_meM/siwAba/siwAbI/besAKwA/TahAkA/ikahAI/ikahAU
ikelA	akelA/akele/kevala/sirPa/mAwra/KAlI/KAlI/basa/nipata/mahaja/sirPa/wanhA/wanahA/ekAkI/ekameva/ekafga/ikelA
bArI-bArI_se	kramaSaH/kramAnusAra/yaWAkrama/silasilevAra/bArI-bArI_se/kramavAra/warawIbavAra/ayugapaxa/alpaSaH
lagaBaga	anxAjana/anxAjana/anxAjana/anxAjana/lagaBaga/wakarIbana/wakarIbana/karIba/karIba/karIbakarIba/karIbana/karIbakarIba/karIbana/anumAnawaH/anakarIba/anakarIba/waKamInana/anxAja_se/ukavAz
kaTorawA_se	nirxayawApUrvaka/nirxayawA_se/berahamI_se/bexarxI_se/krUrawApUrvaka/barbarawApUrvaka/kaTorawA_se/kadAI_se
pUrvavawa	pUrvavaw/pUrvavawa
XarmArWa	XarmArWa
girawe-padawe	girawe_padawe/girawe-padawe
AsapAsa	pAsa_meM/najaxIka/najaxIka/nikata_meM/karIba_meM/samIpa/nikata/pAsa/karIba/karIba/sannikata/najIka/muwwasila/arvAka/avixUra/Are/AsapAsa/Asa-pAsa/Asa-pAsa/AsapAsa/agala-bagala/agala-bagala/AjU-bAjU/irxa-girxa/adosa-padosa/pAsa-padosa/pAsa_padosa
eka_waraPa	eka_ora/eka_waraPa/eka_waraPa/xarakinAra/xUra/alaga/eka_waraPa/eka_ora/alahaxA
anxAja_se	anxAjana/anxAjana/anxAjana/anxAjana/lagaBaga/wakarIbana/wakarIbana/karIba/karIba/karIbakarIba/karIbana/karIbakarIba/karIbana/anumAnawaH/anakarIba/anakarIba/waKamInana/anxAja_se/ukavAz
viSiRtawaH	viSeRakara/KAsakara/KAsa_wOra_para/KAsa_wOra_se/KAsawOra_para/KAsawOra_se/KAsawOra_para/KAsawOra_se/KAsakara/viSeRawaH/viSiRtawaH/muKyawaH/viSeRa_rUpa_se
saMyogavaSa	saMyogavaSa/iwwiPAkana/iwwiPAkana/iwwaPAkana/iwwaPAkana/saMyogavaSAw
ahewuka	vyarWa/PajUla/PijUla/PijUla/anerA/yoM_hI/vqWA/apArWa/bAxa-havAI/bAxahavAI/ahewu/ahewuka/aviraWA
xaSagunA	xasagunA/xaSagunA/xasa_gunA/xaSa_gunA
anXAXunXa	anXAXunXa/bewahASA/anXAXunXa/anXaXunXa/anXaXunXa/utakkara
waBI	waBI/waba_hI/usI_samaya/usI_GadI/waBI/isI_kAraNa
joraSora_se	jora-Sora_se/jora-Sora_se/joraSora_se/joraSora_se/joroM_se/joroM_se
jarA-sA	jarA/jarA/jarA-sA/jarA-sA/rawwiBara/WodA/WodA-sA/WodA_sA/wanika/yawkiMciw
jEse-jEse	jEse-jEse/jyoM-jyoM
ajOM	aba_waka/aBI_waka/Aja_waka/abawaka/aBIwaka/Ajawaka/ajahuz/ajahUz/ajo/ajOM/abalaga
anasoce	vicArahInawaH/anasoce/besoce_samaJe
aprawIRa	anusAra/mAPika/muwAbika/anukUla/muAPika/muAPika/muwAbika/aprawIRa
kevala	akelA/akele/kevala/sirPa/mAwra/KAlI/KAlI/basa/nipata/mahaja/sirPa/wanhA/wanahA/ekAkI/ekameva/ekafga/ikelA
KUba	bahuwa/KUba/KUba/badA/jyAxA/jyAxA/aXika/kAPI/kAPI/kadA/jamakara/datakara
Asafga	lagAwAra/anavarawa/niranwara/niranwara/wAbadawoda/xanAxana/sawawa/XUAzXAra/ananwara/ananwara/avirAmawaH/aniSa/prawikRaNa/anukRaNa/XadAXada/avirawa/muwwasila/avicCinna/avicCexa/aviSrAnwa/aviSrAnwa/asarAra/aharaha/Asafga/Asafga/ikawAra
XadAXada	lagAwAra/anavarawa/niranwara/niranwara/wAbadawoda/xanAxana/sawawa/XUAzXAra/ananwara/ananwara/avirAmawaH/aniSa/prawikRaNa/anukRaNa/XadAXada/avirawa/muwwasila/avicCinna/avicCexa/aviSrAnwa/aviSrAnwa/asarAra/aharaha/Asafga/Asafga/ikawAra/XadAXada
ikawAra	lagAwAra/anavarawa/niranwara/niranwara/wAbadawoda/xanAxana/sawawa/XUAzXAra/ananwara/ananwara/avirAmawaH/aniSa/prawikRaNa/anukRaNa/XadAXada/avirawa/muwwasila/avicCinna/avicCexa/aviSrAnwa/aviSrAnwa/asarAra/aharaha/Asafga/Asafga/ikawAra
xinoMxina	xina-prawixina/xina-xina/xina-para-xina/xina-baxina/xina-ba_xina/xinaprawixina/xinaxina/xinabaxina/xinoM-xina/xinoMxina
waxoparAnwa	wawapaScAwa/waxananwara/waxauparAnwa/waxoparAnwa/waxanwara/waxananwara/waxuparAnwa/waxuparAnwa/waxoparAnwa/waxoparAnwa/waxanwara/wawapaScAwa/waxananwara/waxauparAnwa/waxoparAnwa/waxanwara/waxananwara/waxuparAnwa/waxuparAnwa/waxoparAnwa/waxoparAnwa/waxanwara
viSeRakara	viSeRakara/KAsakara/KAsa_wOra_para/KAsa_wOra_se/KAsawOra_para/KAsawOra_se/KAsawOra_para/KAsawOra_se/KAsakara/viSeRawaH/viSiRtawaH/muKyawaH/viSeRa_rUpa_se
ikabAragI	acAnaka/ekAeka/sahasA/ekabAragI/ikabAragI/yakAyaka/akasmAwa/akasmAw/anAyAsa/xEvAw/xEvavaSa/Ocaka/aprawyASiwawaH/ApAwawaH/aFcakEM/agawyA/acaka/acAFcaka/acAkA/acAka/acAna/anAgawaH/anyAsa/nAgahAz/AcAna/ikahAI/ikahAU/iwwiPAkana/iwwiPAkana/iwwaPAkana/iwwaPAkana/ucakA/Ocaka
petakEyAz	pata/patta/petakEyAz
bAhara	bAhara/bAhara/bAhara
karIne_se	warIke_se/warIke_se/warawIba_se/karIne_se/karIne_se/vyavasWApUrvaka/vyavasWiwawaH/karInAvAra/karInAvAra
anxara	anxara/anxara/BIwara/anxara/anxara/BIwara
kisa_vAswe	kyoM/kisalie/kisa_vAswe
asala_meM	vAkaI/vAkaI/vAswava_meM/hakIkawana/hakIkawana/xaraasala/asala_meM/sacamuca/saccI-muccI/saccI_muccI/sawyawaH/vaswuwaH
TusATusa	TasATasa/TuzsATuzsa/KacAKaca/TusATusa
bevakwa	kusamaya/galawa_vakwa_para/asamaya/bevakwa/galawa_vakwa_para/bevakwa/bemOke/asamaya/bevakwa/bevakwa/galawa_samaya_para/galawa_samaya_para/bemOke
aprayawnawaH	anAyAsa/binA_pariSrama/aprayawnawaH/prayawnahInawaH/ayAsa
AhiswA_se	XIre/XIme/hOle/Ahiswe/AhiswA/Ahiswe_se/AhiswA_se/Asawe/Aswe
aharaha	lagAwAra/anavarawa/niranwara/niranwara/wAbadawoda/xanAxana/sawawa/XUAzXAra/ananwara/ananwara/avirAmawaH/aniSa/prawikRaNa/anukRaNa/XadAXada/avirawa/muwwasila/avicCinna/avicCexa/aviSrAnwa/aviSrAnwa/asarAra/aharaha/Asafga/Asafga/ikawAra/prawixina/haraxina/niwya/hararoja/roja/niwa/roja/rojAnA/rojAnA/anuxina/niwyaprawi/anuxivasa/aharaha/hameSA/saxA/niwya/saxEva/niwya_prawi/sarvaxA/sarvaWA/haraxama/haravakwa/harasamaya/xina-rAwa/xinarAwa/xina_rAwa/rAwa-xina/rAwaxina/niSixina/nisa-vAsara/nisavAsara/niSivAsara/niranwara/niranwara/anavaXi/sarvaxEva/aharaha/pinnA/aharniSa/ahorAwra
cuswI_se	sPUrwipUrvaka/cuswI_se/PurwI_se/muswExI_se
SAyaxa	samBavawaH/SAyaxa/syaw
sasamaya	samayAnusAra/yaWAsamaya/sasamaya
avilamba	Jatapata/catapata/PatAPata/wuranwa/wuranwa/wawkAla/avilamba/avilamba/POrana/POrana/KatAka_se/wawkRaNa/wadAka_se/wada_se/wapAka_se/awiSIGra/awiSIGrawaH/jalxa_se_jalxa/jalxI_se_jalxI/wada_se/hAWoM-hAWa/hAWoM_hAWa/hAWo-hAWa/hAWo_hAWa/Kata_se/Anana-PAnana_meM/AnanaPAnana_meM/siwAba/siwAbI/besAKwA/TahAkA/ikahAI/ikahAU
SeKI_mArawe_hue	SeKI_mArawe_hue/dIMga_mArawe_hue
nIce	nIce/aXaH/nimnawaH/aXo_xiSA_meM/wale/nIce
anukRaNa	lagAwAra/anavarawa/niranwara/niranwara/wAbadawoda/xanAxana/sawawa/XUAzXAra/ananwara/ananwara/avirAmawaH/aniSa/prawikRaNa/anukRaNa/XadAXada/avirawa/muwwasila/avicCinna/avicCexa/aviSrAnwa/aviSrAnwa/asarAra/aharaha/Asafga/Asafga/ikawAra/prawikRaNa/pala_pala/pala-pala/prawipala/hara_kRaNa/kRaNa-kRaNa/haraGadI/hara_GadI/prawi_kRaNa/kRaNakRaNa/anukRaNa/CinaCina/Cina-Cina/AKana
mAwra	akelA/akele/kevala/sirPa/mAwra/KAlI/KAlI/basa/nipata/mahaja/sirPa/wanhA/wanahA/ekAkI/ekameva/ekafga/ikelA
bAxa_meM	bAxa/bAxa_meM/paScAw/uparAnwa/ananwara/paScAwa/uparAnwa/ananwara/pICe/uwwara/aWa/anupaxa/anvakRa
waba_BI	Pira_BI/waWApi/waba_BI
pUrI_waraha_se	bilkula/bilakula/ekaxama/nipata/sarAsara/TIka/niwAnwa/niwAnwa/pUrNawaH/pUrI_waraha_se/pUrNawayA/sampUrNawaH/sampUrNawayA/pUrNarupeNa/AmUlacUla/Sawa-prawiSawa
AiMxA	aba/Age/AiMxA/AiMxA/AyanxA/AyanxA
nITi	kaTinAI_se/jEse_wEse/muSkila_se/bamuSkila/kaTinawaH/nITi
kahIM_Ora	anyawra/kahIM_Ora/anawa
sAkRAw	svayaM/svawaH/Kuxa/Kuxa/Apa/ApahI/apaneApa/Kuxa_hI/sAkRAw/sAkRAwa/asAlawana/AparUpa
aXikAMSawayA	aXikawaH/aXikAMSawaH/prAyaH/aXikAMSawayA/prAyaH/akasara/aksara/aXikawara/aXikAMSawaH/jyAxAwara/bahuXA/AmawOra_para/AmawOra_se/aXikAMSawayA/prAyaSaH/anekaXA
cAra_gunA	cOgunA/cAra_gunA/cAragunA/cawurguNa
sAvaXAnI_se	sAvaXAnIpUrvaka/XyAnapUrvaka/XyAna_se/sAvaXAnI_se/sAvaXAnawaH/samBAlakara/samBAlakara
pahale	awIwa_meM/pahale/BUwa_meM/BUwa_kAla_meM/pICe/piCale_xinoM_meM/AramBa_meM/AramBawaH/AramBawaH/pahale/SurU_meM/praWama/Axi_meM/praWamawaH/sarvapraWama/pUrva/SuruAwa_meM/SuruvAwa_meM/AramBa_meM/prAramBa_meM/pahale
viXAnawaH	kAnUnana/kAnUnana/viXAnawaH
AxyopAnwa	AxyopAnwa/AxyopAnwa/AxyAnwa/AxyAnwa
kahe_muwAbika	kaWanAnusAra/kahanAnusAra/kahe_muwAbika/kahe_muwAbika/kahe_anusAra
yakInana	niHsanxeha/nissanxeha/jarUra/jarUra/niHsanxeha/nissanxeha/nisanxeha/nisanxeha/binA_Saka/beSaka/bilkula/bilakula/yakInana/yakInana/avaSyameva/avaSya/alabawwA/bilASaka/aBarama/vASiMxA/bASiMxA/avasi/aviwarkika/asaMSaya/niSciwawaH/ikafka
jyAxAwara	prAyaH/akasara/aksara/aXikawara/aXikAMSawaH/jyAxAwara/bahuXA/AmawOra_para/AmawOra_se/aXikAMSawayA/prAyaSaH/anekaXA
KuSI_KuSI	prasannawApUrvaka/KuSI_KuSI/KuSI_KuSI/KuSI_se/KuSI_se/prasannawaH/saharRa/harRapUrvaka
xUrI_para	xUra/xUrI_para/alaga/pare
isa_varRa	aso/asoM/AsO/isa_varRa/isa_sAla
xugunA	xugunA/xUnA/xogunA/xuganA/xviguNa/xviguNiwa
aviSrAnwa	lagAwAra/anavarawa/niranwara/niranwara/wAbadawoda/xanAxana/sawawa/XUAzXAra/ananwara/ananwara/avirAmawaH/aniSa/prawikRaNa/anukRaNa/XadAXada/avirawa/muwwasila/avicCinna/avicCexa/aviSrAnwa/aviSrAnwa/asarAra/aharaha/Asafga/Asafga/ikawAra
xinaxina	xina-prawixina/xina-xina/xina-para-xina/xina-baxina/xina-ba_xina/xinaprawixina/xinaxina/xinabaxina/xinoM-xina/xinoMxina
awyaXika	awyanwa/awyanwa/awyaXika/be-iMwahA/beiMwahA/bahuwa_aXika/bahuwa_hI/bepanAha/saKwa/saKwa/jamakara/mahA/nihAyawa/cUdAnwa/cUdAnwa/aByaXika/Agara
muAPika	anusAra/mAPika/muwAbika/anukUla/muAPika/muAPika/muwAbika/aprawIRa
namrawApUrvaka	namrawApUrvaka/vinayapUrvaka
animeRa	takatakI_se/ekataka/tukura_tukura/taka-taka/animeRa/animiRa/animiKa/anamiKa/ikataka
xara-xara	xara-xara/xara-baxara/xvAra-xvAra
jisa_prakAra_se	jEsA/jEse/jisa_prakAra/jisa_prakAra_se
wada_se	Jatapata/catapata/PatAPata/wuranwa/wuranwa/wawkAla/avilamba/avilamba/POrana/POrana/KatAka_se/wawkRaNa/wadAka_se/wada_se/wapAka_se/awiSIGra/awiSIGrawaH/jalxa_se_jalxa/jalxI_se_jalxI/wada_se/hAWoM-hAWa/hAWoM_hAWa/hAWo-hAWa/hAWo_hAWa/Kata_se/Anana-PAnana_meM/AnanaPAnana_meM/siwAba/siwAbI/besAKwA/TahAkA/ikahAI/ikahAU/Jatapata/catapata/PatAPata/wuranwa/wuranwa/wawkAla/avilamba/avilamba/POrana/POrana/KatAka_se/wawkRaNa/wadAka_se/wada_se/wapAka_se/awiSIGra/awiSIGrawaH/jalxa_se_jalxa/jalxI_se_jalxI/wada_se/hAWoM-hAWa/hAWoM_hAWa/hAWo-hAWa/hAWo_hAWa/Kata_se/Anana-PAnana_meM/AnanaPAnana_meM/siwAba/siwAbI/besAKwA/TahAkA/ikahAI/ikahAU/wada_se/wadAka_se
aFcakEM	acAnaka/ekAeka/sahasA/ekabAragI/ikabAragI/yakAyaka/akasmAwa/akasmAw/anAyAsa/xEvAw/xEvavaSa/Ocaka/aprawyASiwawaH/ApAwawaH/aFcakEM/agawyA/acaka/acAFcaka/acAkA/acAka/acAna/anAgawaH/anyAsa/nAgahAz/AcAna/ikahAI/ikahAU/iwwiPAkana/iwwiPAkana/iwwaPAkana/iwwaPAkana/ucakA/Ocaka
AramBawaH	AramBa_meM/AramBawaH/AramBawaH/pahale/SurU_meM/praWama/Axi_meM/praWamawaH/sarvapraWama/pUrva/SuruAwa_meM/SuruvAwa_meM/AramBa_meM/prAramBa_meM
Kuxa-ba-Kuxa	svawaH/apaneApa/Kuxa-ba-Kuxa/KuxabaKuxa/Kuxa-ba-Kuxa/KuxabaKuxa
jisa_prakAra	jEsA/jEse/jisa_prakAra/jisa_prakAra_se
samAnwara	samAnwara/samAnAnwara/samAnwara/samAnAnwara
isa_bIca	iwane_meM/isa_bIca/isI_bIca/isa_xOrAna/isa_xaramyAna
savirAmawaH	ruka-ruka_kara/ruka-rukakara/virAmawaH/Tahara_Tahara_kara/savirAmawaH
aviraWA	vyarWa/PajUla/PijUla/PijUla/anerA/yoM_hI/vqWA/apArWa/bAxa-havAI/bAxahavAI/ahewu/ahewuka/aviraWA
bagEra	binA/bagEra/bagEra
SiRtAcArapUrvaka	SiRtawaH/saByawaH/bAsaUra/SAlInawaH/SiRtAcArapUrvaka/salIke_se
maraNoparAnwa	maraNoparAnwa/maraNoparAnwa
sare_Ama	KuleAma/Kulakara/sareAma/sare-Ama/Kule-Ama/Kullama-KullA/KullamaKullA/dafke_kI_cota_para/sare_Ama/agupwawaH
iwanA	iwanA/iwA/iweka/iwe
anxAjana	anxAjana/anxAjana/anxAjana/anxAjana/lagaBaga/wakarIbana/wakarIbana/karIba/karIba/karIbakarIba/karIbana/karIbakarIba/karIbana/anumAnawaH/anakarIba/anakarIba/waKamInana/anxAja_se/ukavAz
yakAyaka	acAnaka/ekAeka/sahasA/ekabAragI/ikabAragI/yakAyaka/akasmAwa/akasmAw/anAyAsa/xEvAw/xEvavaSa/Ocaka/aprawyASiwawaH/ApAwawaH/aFcakEM/agawyA/acaka/acAFcaka/acAkA/acAka/acAna/anAgawaH/anyAsa/nAgahAz/AcAna/ikahAI/ikahAU/iwwiPAkana/iwwiPAkana/iwwaPAkana/iwwaPAkana/ucakA/Ocaka
gupacupa_rUpa_se	gupwawaH/gupacupa_rUpa_se/corI_Cipe
berahamI_se	nirxayawApUrvaka/nirxayawA_se/berahamI_se/bexarxI_se/krUrawApUrvaka/barbarawApUrvaka/kaTorawA_se/kadAI_se
xina-prawixina	xina-prawixina/xina-xina/xina-para-xina/xina-baxina/xina-ba_xina/xinaprawixina/xinaxina/xinabaxina/xinoM-xina/xinoMxina
isI_kRaNa	aBI-aBI/aBI_aBI/aBI_hI/isI_vakwa/isI_kRaNa
niranwara	lagAwAra/anavarawa/niranwara/niranwara/wAbadawoda/xanAxana/sawawa/XUAzXAra/ananwara/ananwara/avirAmawaH/aniSa/prawikRaNa/anukRaNa/XadAXada/avirawa/muwwasila/avicCinna/avicCexa/aviSrAnwa/aviSrAnwa/asarAra/aharaha/Asafga/Asafga/ikawAra/hameSA/saxA/niwya/saxEva/niwya_prawi/sarvaxA/sarvaWA/haraxama/haravakwa/harasamaya/xina-rAwa/xinarAwa/xina_rAwa/rAwa-xina/rAwaxina/niSixina/nisa-vAsara/nisavAsara/niSivAsara/niranwara/niranwara/anavaXi/sarvaxEva/aharaha/pinnA/aharniSa/ahorAwra
wiwara-biwara	wiwara-biwara/aswa-vyaswa/Cinna-Binna/bewarawIba/aswavyaswa/_avyavasWiwa
Agara	awyanwa/awyanwa/awyaXika/be-iMwahA/beiMwahA/bahuwa_aXika/bahuwa_hI/bepanAha/saKwa/saKwa/jamakara/mahA/nihAyawa/cUdAnwa/cUdAnwa/aByaXika/Agara
akasmAwa	acAnaka/ekAeka/sahasA/ekabAragI/ikabAragI/yakAyaka/akasmAwa/akasmAw/anAyAsa/xEvAw/xEvavaSa/Ocaka/aprawyASiwawaH/ApAwawaH/aFcakEM/agawyA/acaka/acAFcaka/acAkA/acAka/acAna/anAgawaH/anyAsa/nAgahAz/AcAna/ikahAI/ikahAU/iwwiPAkana/iwwiPAkana/iwwaPAkana/iwwaPAkana/ucakA/Ocaka
salIke_se	SiRtawaH/saByawaH/bAsaUra/SAlInawaH/SiRtAcArapUrvaka/salIke_se
pahale_se	pahale_se/pUrvawaH/pahale_se_hI
nAKuSI_se	aprasannawApUrvaka/nArAjagIpUrvaka/nAKuSI_se/nArAjagIpUrvaka/nAKuSI_se
prAramBa_meM	AramBa_meM/AramBawaH/AramBawaH/pahale/SurU_meM/praWama/Axi_meM/praWamawaH/sarvapraWama/pUrva/SuruAwa_meM/SuruvAwa_meM/AramBa_meM/prAramBa_meM
AnanaPAnana_meM	Jatapata/catapata/PatAPata/wuranwa/wuranwa/wawkAla/avilamba/avilamba/POrana/POrana/KatAka_se/wawkRaNa/wadAka_se/wada_se/wapAka_se/awiSIGra/awiSIGrawaH/jalxa_se_jalxa/jalxI_se_jalxI/wada_se/hAWoM-hAWa/hAWoM_hAWa/hAWo-hAWa/hAWo_hAWa/Kata_se/Anana-PAnana_meM/AnanaPAnana_meM/siwAba/siwAbI/besAKwA/TahAkA/ikahAI/ikahAU
bArIkI_se	bArIkI_se/bArIkI_se/sUkRmawaH
isa_prakAra	yoM/yUz/Ese/isa_waraha/isa_prakAra/EsA/iwWaM/ima/imi/iBa/iva/isE/IxqS/IxqSa
eka_xUsare_se	paraspara/Apasa_meM/eka_xUsare_se/iwarewara
subaha-subaha	sabere/savere/subaha/wadake/subaha-subaha/subaha_savere
niRkAraNa	akAraNa/bemawalaba/niRkAraNa/kAraNahInawaH/animiwwa
waxuparAnwa	wawapaScAwa/waxananwara/waxauparAnwa/waxoparAnwa/waxanwara/waxananwara/waxuparAnwa/waxuparAnwa/waxoparAnwa/waxoparAnwa/waxanwara
Ese_hI	akAraNa/prayojanahInawaH/Ese_hI/yUz_hI/kAraNahInawaH/bevajaha/uxxeSyahInawaH/vyarWa_hI/yoM_hI/JUTa-mUTa/yOM_hI/yUz_hI/Ese_hI/nAhaka/nAhaka/PajUla/PajUla/PijUla/PijUla/anahaka/anAhaka
KullamaKullA	KuleAma/Kulakara/sareAma/sare-Ama/Kule-Ama/Kullama-KullA/KullamaKullA/dafke_kI_cota_para/sare_Ama/agupwawaH
XIre_XIre	XIre-XIre/XIre_XIre/Ahiswe-Ahiswe/AhiswA-AhiswA/hOle-hOle/hole-hole/raPwA-raPwA/alpaSaH
kAraNahInawaH	akAraNa/bemawalaba/niRkAraNa/kAraNahInawaH/animiwwa/akAraNa/prayojanahInawaH/Ese_hI/yUz_hI/kAraNahInawaH/bevajaha/uxxeSyahInawaH
pICe-pICe	pICe-pICe/anupaxa/kaxama-ba_kaxama
rimaJima	rimaJima/rimaJima-rimaJima/rima-Jima
majabUrana	majabUrana/vivaSawaH/anacAhe/majabUrana/vivaSa_hokara/cAranAcAra/anwawogawvA/barabasa
rAwa-xina	hameSA/saxA/niwya/saxEva/niwya_prawi/sarvaxA/sarvaWA/haraxama/haravakwa/harasamaya/xina-rAwa/xinarAwa/xina_rAwa/rAwa-xina/rAwaxina/niSixina/nisa-vAsara/nisavAsara/niSivAsara/niranwara/niranwara/anavaXi/sarvaxEva/aharaha/pinnA/aharniSa/ahorAwra
Kata_se	Jatapata/catapata/PatAPata/wuranwa/wuranwa/wawkAla/avilamba/avilamba/POrana/POrana/KatAka_se/wawkRaNa/wadAka_se/wada_se/wapAka_se/awiSIGra/awiSIGrawaH/jalxa_se_jalxa/jalxI_se_jalxI/wada_se/hAWoM-hAWa/hAWoM_hAWa/hAWo-hAWa/hAWo_hAWa/Kata_se/Anana-PAnana_meM/AnanaPAnana_meM/siwAba/siwAbI/besAKwA/TahAkA/ikahAI/ikahAU
bewahASA	anXAXunXa/bewahASA/anXAXunXa/anXaXunXa/anXaXunXa/utakkara
AramBa_meM	AramBa_meM/AramBawaH/AramBawaH/pahale/SurU_meM/praWama/Axi_meM/praWamawaH/sarvapraWama/pUrva/SuruAwa_meM/SuruvAwa_meM/AramBa_meM/prAramBa_meM
xina-rAwa	hameSA/saxA/niwya/saxEva/niwya_prawi/sarvaxA/sarvaWA/haraxama/haravakwa/harasamaya/xina-rAwa/xinarAwa/xina_rAwa/rAwa-xina/rAwaxina/niSixina/nisa-vAsara/nisavAsara/niSivAsara/niranwara/niranwara/anavaXi/sarvaxEva/aharaha/pinnA/aharniSa/ahorAwra
AmaraNa	mqwyuparyanwa/AjIvana/wAumra/umraBara/jiMxagIBara/jiMxagIBara/jIvanaBara/AmaraNa/anwima_xama_waka
sASru	sASru
CamaCama	CamaCama/Cama-Cama
kawwaI	kaxApi/haragija/kawaI/kawwaI
varIyawA_se	aXimAnawaH/varIyawA_se/acCA_ho_ki
AhiswA-AhiswA	XIre-XIre/XIre_XIre/Ahiswe-Ahiswe/AhiswA-AhiswA/hOle-hOle/hole-hole/raPwA-raPwA/alpaSaH
ananwara	bAxa/bAxa_meM/paScAw/uparAnwa/ananwara/paScAwa/uparAnwa/ananwara/pICe/uwwara/aWa/anupaxa/anvakRa/lagAwAra/anavarawa/niranwara/niranwara/wAbadawoda/xanAxana/sawawa/XUAzXAra/ananwara/ananwara/avirAmawaH/aniSa/prawikRaNa/anukRaNa/XadAXada/avirawa/muwwasila/avicCinna/avicCexa/aviSrAnwa/aviSrAnwa/asarAra/aharaha/Asafga/Asafga/ikawAra
pUrI_waraha	pUrA/pUrI_waraha
howe_havAwe	anwawaH/anwawogawvA/anwa_meM/AKira/AKira/AKirakAra/AKirakAra/howe_havAwe
kAma_se	prayojanawaH/kAma_se/kAraNa_se/saprayojana
paraspara	paraspara/Apasa_meM/eka_xUsare_se/iwarewara
kaBIkaBAra	kaBIkaBI/kaBIkaBAra/yaxAkaxA/kaBI-kaBI/kaBI-kaBAra/yaxA-kaxA/vakwan-POvakwan
bahuwa_bAra	kaI_bAra/bahuwa_bAra/anekaSaH
masalana	uxAharaNArWa/uxAharaNawaH/uxAharaNa_svarUpa/masalana
xina-baxina	xina-prawixina/xina-xina/xina-para-xina/xina-baxina/xina-ba_xina/xinaprawixina/xinaxina/xinabaxina/xinoM-xina/xinoMxina
asAvaXAnI_se	asAvaXAnawaH/asAvaXAnI_se/XyAnahInawaH/lAparavAhI_se
isa_xaramyAna	iwane_meM/isa_bIca/isI_bIca/isa_xOrAna/isa_xaramyAna
XIre	XIre/XIme/hOle/Ahiswe/AhiswA/Ahiswe_se/AhiswA_se/Asawe/Aswe
xarasAla	harasAla/prawivarRa/xarasAla/anuvawsara
AhiswA	XIre/XIme/hOle/Ahiswe/AhiswA/Ahiswe_se/AhiswA_se/Asawe/Aswe
jyAxA	Upara/aXika/jyAxA/jyAxA/bahuwa/KUba/KUba/badA/jyAxA/jyAxA/aXika/kAPI/kAPI/kadA/jamakara/datakara
aniSa	lagAwAra/anavarawa/niranwara/niranwara/wAbadawoda/xanAxana/sawawa/XUAzXAra/ananwara/ananwara/avirAmawaH/aniSa/prawikRaNa/anukRaNa/XadAXada/avirawa/muwwasila/avicCinna/avicCexa/aviSrAnwa/aviSrAnwa/asarAra/aharaha/Asafga/Asafga/ikawAra
kiswavAra	kiswavAra/kiswavAra/kiswa_xara_kiswa/kiswoM_meM
Ahiswe	XIre/XIme/hOle/Ahiswe/AhiswA/Ahiswe_se/AhiswA_se/Asawe/Aswe
awyaXika_prayawnapUrvaka	awyaXika_prayawnapUrvaka/mara-marakara
KuxabaKuxa	svawaH/apaneApa/Kuxa-ba-Kuxa/KuxabaKuxa/Kuxa-ba-Kuxa/KuxabaKuxa
nawIjawana	PalasvarUpa/pariNAma_svarUpa/pariNAmasvarUpa/pariNAmawaH/PalawaH/nawIjawana
narasoM	narasoM/awarasoM/warasoM/narasoM/awarasoM/warasoM
nipata	bilkula/bilakula/ekaxama/nipata/sarAsara/TIka/niwAnwa/niwAnwa/pUrNawaH/pUrI_waraha_se/pUrNawayA/sampUrNawaH/sampUrNawayA/pUrNarupeNa/AmUlacUla/Sawa-prawiSawa/akelA/akele/kevala/sirPa/mAwra/KAlI/KAlI/basa/nipata/mahaja/sirPa/wanhA/wanahA/ekAkI/ekameva/ekafga/ikelA
svecCayA	svecCApUrvaka/icCA_se/KuSI_KuSI/KuSI_se/svecCayA/svecCawaH
anXaXunXa	anXAXunXa/bewahASA/anXAXunXa/anXaXunXa/anXaXunXa/utakkara
iwanA_hI	iwanA_hI/iwimAwra
kqwrima_rUpa_se	kqwrima_rUpa_se/kqwrimawA_se
xasa_gunA	xasagunA/xaSagunA/xasa_gunA/xaSa_gunA
animiRa	takatakI_se/ekataka/tukura_tukura/taka-taka/animeRa/animiRa/animiKa/anamiKa/ikataka
akAraNa	akAraNa/bemawalaba/niRkAraNa/kAraNahInawaH/animiwwa/akAraNa/prayojanahInawaH/Ese_hI/yUz_hI/kAraNahInawaH/bevajaha/uxxeSyahInawaH
edI	IsA_paScAw/I_pa/edI/IsA_paScAw
aBI_hI	aBI-aBI/aBI_aBI/aBI_hI/isI_vakwa/isI_kRaNa
eka_ora	eka_ora/eka_waraPa/eka_waraPa/xarakinAra/xUra/alaga/eka_waraPa/eka_ora/alahaxA
avvalana	pahale_pahala/praWamawaH/sarva_praWama/sarvapraWama/SurU_meM/pahale-pahala/avvalana/pahile_pahala/pahile_pahala
yahAz_para	iXara/isa_ora/yahAz_para/iwaH/iwa/iwE/iwWe
kuviXipUrvaka	viXihInawaH/kuviXipUrvaka/bewarIke
xUnA	xugunA/xUnA/xogunA/xuganA/xviguNa/xviguNiwa
AwafkapUrvaka	AwafkapUrvaka/sAwafka
beSaka	niHsanxeha/nissanxeha/jarUra/jarUra/niHsanxeha/nissanxeha/nisanxeha/nisanxeha/binA_Saka/beSaka/bilkula/bilakula/yakInana/yakInana/avaSyameva/avaSya/alabawwA/bilASaka/aBarama/vASiMxA/bASiMxA/avasi/aviwarkika/asaMSaya/niSciwawaH/ikafka
jAnabUJakara	jAna-bUJakara/jAnabUJakara/jAnabUJa_kara/amaxana/icCApUrvaka/mawipUrva/irAxawana
sAXAraNawaH	sAmAnyawaH/sAmAnyawayA/sAXAraNawaH/sAXAraNawayA/amUmana/umUmana
balapUrvaka	balapUrvaka/barabasa/jabaraxaswI/jabaraxaswI/jabarana/jabarana/barajorI
warawIbavAra	kramaSaH/kramAnusAra/yaWAkrama/silasilevAra/bArI-bArI_se/kramavAra/warawIbavAra/ayugapaxa/alpaSaH
BarapUra	BalI-BAzwi/BalI_BAzwi/BarapUra/BalIBAzwi/BalI-BAnwi/BalI_BAnwi/BalIBAnwi/sarvawoBAva/acCI_waraha
xaraparaxA	cupake_se/cupake-cupake/xaraparaxA
jalxa_se_jalxa	Jatapata/catapata/PatAPata/wuranwa/wuranwa/wawkAla/avilamba/avilamba/POrana/POrana/KatAka_se/wawkRaNa/wadAka_se/wada_se/wapAka_se/awiSIGra/awiSIGrawaH/jalxa_se_jalxa/jalxI_se_jalxI/wada_se/hAWoM-hAWa/hAWoM_hAWa/hAWo-hAWa/hAWo_hAWa/Kata_se/Anana-PAnana_meM/AnanaPAnana_meM/siwAba/siwAbI/besAKwA/TahAkA/ikahAI/ikahAU
Pira_se	xubArA/xobArA/Pira/Pira_se/punaH/eka_bAra_Pira/vApasa_se
vilambapUrvaka	vilambawaH/aSIGrawaH/xerI_se/vilambapUrvaka/xera_meM
AxeSapUrvaka	AjFApUrvaka/AxeSapUrvaka/sAxeSa/AxeSa_se
xara-baxara	xara-xara/xara-baxara/xvAra-xvAra
binamAzge	binamAzge/bina_mAzge/anamAzge/ayAciwawaH
weja	kasakara/joraxAra/weja/weja/wIvra/wejI_se/jora_se/wejI_se/jora_se/wIvrawA_se
kahe_anusAra	kaWanAnusAra/kahanAnusAra/kahe_muwAbika/kahe_muwAbika/kahe_anusAra
kqpApUrvaka	xayApUrvaka/kqpA_kara_ke/kqpApUrvaka/xayA_se/barAe_meharabAnI/kqpayA/kqpApUrvaka/kqpA_pUrvaka/kqpA_karake/meharabAnI_karake
pUrva	AramBa_meM/AramBawaH/AramBawaH/pahale/SurU_meM/praWama/Axi_meM/praWamawaH/sarvapraWama/pUrva/SuruAwa_meM/SuruvAwa_meM/AramBa_meM/prAramBa_meM
karIne_se	warIke_se/warIke_se/warawIba_se/karIne_se/karIne_se/vyavasWApUrvaka/vyavasWiwawaH/karInAvAra/karInAvAra
sAWa-sAWa	sAWa-sAWa/sAWa_hI/sAWa_hI_sAWa/sAWa/eka_sAWa/ikatTA/ikajora/ekawra/ikawra
kAraNawaH	kAraNavaSa/kAraNawaH
isa_sAla	aso/asoM/AsO/isa_varRa/isa_sAla
bagamela	bagamela/baga-mela
sahiwa	sahiwa/samewa
WodA-WodA	alpawaH/WodA-WodA/WodA_WodA/alpaSaH
waxanwara	wawapaScAwa/waxananwara/waxauparAnwa/waxoparAnwa/waxanwara/waxananwara/waxuparAnwa/waxuparAnwa/waxoparAnwa/waxoparAnwa/waxanwara
aXikArahInawaH	anaXikAra/aXikArahInawaH
agupwawaH	KuleAma/Kulakara/sareAma/sare-Ama/Kule-Ama/Kullama-KullA/KullamaKullA/dafke_kI_cota_para/sare_Ama/agupwawaH
wibArA	wibArA/webArA
alaga	xUra/xUrI_para/alaga/pare/xarakinAra/xUra/alaga/eka_waraPa/eka_ora/alahaxA
ayugapaxa	kramaSaH/kramAnusAra/yaWAkrama/silasilevAra/bArI-bArI_se/kramavAra/warawIbavAra/ayugapaxa/alpaSaH
agawyA	acAnaka/ekAeka/sahasA/ekabAragI/ikabAragI/yakAyaka/akasmAwa/akasmAw/anAyAsa/xEvAw/xEvavaSa/Ocaka/aprawyASiwawaH/ApAwawaH/aFcakEM/agawyA/acaka/acAFcaka/acAkA/acAka/acAna/anAgawaH/anyAsa/nAgahAz/AcAna/ikahAI/ikahAU/iwwiPAkana/iwwiPAkana/iwwaPAkana/iwwaPAkana/ucakA/Ocaka/BaviRya_meM/Age/BaviRya_kAla_meM/agawyA
xubArA	xubArA/xobArA/Pira/Pira_se/punaH/eka_bAra_Pira/vApasa_se
aswavyaswa	wiwara-biwara/aswa-vyaswa/Cinna-Binna/bewarawIba/aswavyaswa/_avyavasWiwa
samaJa-bUJakara	soca-vicArakara/samaJa-bUJakara/vicArapUrvaka/soca-samaJakara/soca_vicAra_kara/samaJa_bUJa_kara/soca_samaJa_kara/vicAriwawaH
pUrNawaH	bilkula/bilakula/ekaxama/nipata/sarAsara/TIka/niwAnwa/niwAnwa/pUrNawaH/pUrI_waraha_se/pUrNawayA/sampUrNawaH/sampUrNawayA/pUrNarupeNa/AmUlacUla/Sawa-prawiSawa
bIcama_bIca	bIcobIca/bIcoMbIca/bIcoM-bIca/bIcama_bIca/bIcoM_bIca
cOgunA	cOgunA/cAra_gunA/cAragunA/cawurguNa
sAPa-sAPa	spaRta/spaRtawaH/Kula_kara/Kule_wOra_para/Kullama_KullA/binA_lAga_lapeta_ke/sAPa_sAPa/spaRtawayA/sAPa-sAPa/sAPa-sAPa
anyaxA	anyexyu/anyaxA
aviwarkika	niHsanxeha/nissanxeha/jarUra/jarUra/niHsanxeha/nissanxeha/nisanxeha/nisanxeha/binA_Saka/beSaka/bilkula/bilakula/yakInana/yakInana/avaSyameva/avaSya/alabawwA/bilASaka/aBarama/vASiMxA/bASiMxA/avasi/aviwarkika/asaMSaya/niSciwawaH/ikafka
CinaCina	prawikRaNa/pala_pala/pala-pala/prawipala/hara_kRaNa/kRaNa-kRaNa/haraGadI/hara_GadI/prawi_kRaNa/kRaNakRaNa/anukRaNa/CinaCina/Cina-Cina/AKana
ke_anxara	ke_anxara/ke_anxara/ke_BIwara/meM
avalambiwa	jalxI/SIGra/SIGrawaH/avilambawaH/jalxa/acira/wUrNa/SiwAba/begi/avalambiwa/avalambiwa/jalxI_se/ASu/avilambiwa/avilambiwa
kqwrimawA_se	kqwrima_rUpa_se/kqwrimawA_se
BinasAre	BinasAre/Binasahare
ayAsa	anAyAsa/binA_pariSrama/aprayawnawaH/prayawnahInawaH/ayAsa
SIGra	jalxI/SIGra/SIGrawaH/avilambawaH/jalxa/acira/wUrNa/SiwAba/begi/avalambiwa/avalambiwa/jalxI_se/ASu/avilambiwa/avilambiwa
ihavAz	yahAz/isa_jagaha/iwaH/iwa/iha/ihAz/ihavAz/IMGe/IhAz
JUTa-mUTa	vyarWa_hI/yoM_hI/JUTa-mUTa/yOM_hI/yUz_hI/Ese_hI/nAhaka/nAhaka/PajUla/PajUla/PijUla/PijUla/anahaka/anAhaka
CahagunA	CahagunA/COgunA/CaHgunA
nissafkoca	nisafkoca/niHsafkoca/nissafkoca/beXadaka/safkocahInawaH/beJiJaka/beKataka/beKatake/behicaka
hara_jagaha	cAroM_ora/cAroM_waraPa/cAroM_waraPa/cahuz_ora/sarvawra/saBI_waraPa/cAroM_xiSAoM_meM/hara_jagaha/irxa-girxa
aXoraXa	Upara-nIce/aXoraXa/aXorXa/aXOrxXa
aBE	aBI/PilahAla/PilahAla/isa_samaya/aba/aWa/aXunA/samprawi/samprawi/aBU/aBE
aBI	aBI/PilahAla/PilahAla/isa_samaya/aba/aWa/aXunA/samprawi/samprawi/aBU/aBE
aBU	aBI/PilahAla/PilahAla/isa_samaya/aba/aWa/aXunA/samprawi/samprawi/aBU/aBE
IsA_pUrva	IsApUrva/IsA_pUrva/IsavI_pUrva
pariNAmawaH	PalasvarUpa/pariNAma_svarUpa/pariNAmasvarUpa/pariNAmawaH/PalawaH/nawIjawana
yoM_hI	vyarWa_hI/yoM_hI/JUTa-mUTa/yOM_hI/yUz_hI/Ese_hI/nAhaka/nAhaka/PajUla/PajUla/PijUla/PijUla/anahaka/anAhaka/vyarWa/PajUla/PijUla/PijUla/anerA/yoM_hI/vqWA/apArWa/bAxa-havAI/bAxahavAI/ahewu/ahewuka/aviraWA
isI_vakwa	aBI-aBI/aBI_aBI/aBI_hI/isI_vakwa/isI_kRaNa
sAPa_sAPa	spaRta/spaRtawaH/Kula_kara/Kule_wOra_para/Kullama_KullA/binA_lAga_lapeta_ke/sAPa_sAPa/spaRtawayA/sAPa-sAPa/sAPa-sAPa
AyanxA	aba/Age/AiMxA/AiMxA/AyanxA/AyanxA
TuzsATuzsa	TasATasa/TuzsATuzsa/KacAKaca/TusATusa
muswExI_se	sPUrwipUrvaka/cuswI_se/PurwI_se/muswExI_se
niScayapUrvaka	safkalpapUrvaka/irAxawana/irAxe_se/xqDawApUrvaka/niScayapUrvaka
Agraha_se	AgrahapUrvaka/Agraha_se
XyAna_se	sAvaXAnIpUrvaka/XyAnapUrvaka/XyAna_se/sAvaXAnI_se/sAvaXAnawaH/samBAlakara/samBAlakara
iwWaMmeva	isI_waraha/isI_prakAra/iwWaMmeva
saBI_waraPa	cAroM_ora/cAroM_waraPa/cAroM_waraPa/cahuz_ora/sarvawra/saBI_waraPa/cAroM_xiSAoM_meM/hara_jagaha/irxa-girxa
eka_sAWa	sAWa-sAWa/sAWa_hI/sAWa_hI_sAWa/sAWa/eka_sAWa/ikatTA/ikajora/ekawra/ikawra
karIbakarIba	anxAjana/anxAjana/anxAjana/anxAjana/lagaBaga/wakarIbana/wakarIbana/karIba/karIba/karIbakarIba/karIbana/karIbakarIba/karIbana/anumAnawaH/anakarIba/anakarIba/waKamInana/anxAja_se/ukavAz
sAxara	sawkArapUrvaka/sAxara/sasammAna/Axara_sahiwa
anamAzge	binamAzge/bina_mAzge/anamAzge/ayAciwawaH
binA	binA/bagEra/bagEra
kahanAnusAra	kaWanAnusAra/kahanAnusAra/kahe_muwAbika/kahe_muwAbika/kahe_anusAra
samprawi	aBI/PilahAla/PilahAla/isa_samaya/aba/aWa/aXunA/samprawi/samprawi/aBU/aBE
Axi_meM	AramBa_meM/AramBawaH/AramBawaH/pahale/SurU_meM/praWama/Axi_meM/praWamawaH/sarvapraWama/pUrva/SuruAwa_meM/SuruvAwa_meM/AramBa_meM/prAramBa_meM
jAna-bUJakara	jAna-bUJakara/jAnabUJakara/jAnabUJa_kara/amaxana/icCApUrvaka/mawipUrva/irAxawana
Jatapata	Jatapata/catapata/PatAPata/wuranwa/wuranwa/wawkAla/avilamba/avilamba/POrana/POrana/KatAka_se/wawkRaNa/wadAka_se/wada_se/wapAka_se/awiSIGra/awiSIGrawaH/jalxa_se_jalxa/jalxI_se_jalxI/wada_se/hAWoM-hAWa/hAWoM_hAWa/hAWo-hAWa/hAWo_hAWa/Kata_se/Anana-PAnana_meM/AnanaPAnana_meM/siwAba/siwAbI/besAKwA/TahAkA/ikahAI/ikahAU
kiMkarwwavya-vimUDa	hakkA-bakkA/BOMcakkA/kiMkarwavya-vimUDa/kiMkarwwavya-vimUDa/kiMkarwavyavimUDa/kiMkarwwavyavimUDa/hawabuxXi
eka_bAra_Pira	xubArA/xobArA/Pira/Pira_se/punaH/eka_bAra_Pira/vApasa_se
anasUyawaH	IrRyAhInawaH/anasUyawaH/xveRahInawaH
avicCinna	lagAwAra/anavarawa/niranwara/niranwara/wAbadawoda/xanAxana/sawawa/XUAzXAra/ananwara/ananwara/avirAmawaH/aniSa/prawikRaNa/anukRaNa/XadAXada/avirawa/muwwasila/avicCinna/avicCexa/aviSrAnwa/aviSrAnwa/asarAra/aharaha/Asafga/Asafga/ikawAra
pala-pala	prawikRaNa/pala_pala/pala-pala/prawipala/hara_kRaNa/kRaNa-kRaNa/haraGadI/hara_GadI/prawi_kRaNa/kRaNakRaNa/anukRaNa/CinaCina/Cina-Cina/AKana
roja	prawixina/haraxina/niwya/hararoja/roja/niwa/roja/rojAnA/rojAnA/anuxina/niwyaprawi/anuxivasa/aharaha
xinarAwa	hameSA/saxA/niwya/saxEva/niwya_prawi/sarvaxA/sarvaWA/haraxama/haravakwa/harasamaya/xina-rAwa/xinarAwa/xina_rAwa/rAwa-xina/rAwaxina/niSixina/nisa-vAsara/nisavAsara/niSivAsara/niranwara/niranwara/anavaXi/sarvaxEva/aharaha/pinnA/aharniSa/ahorAwra
Gara-Gara	Gara-Gara/Gara_Gara
anacAhe	majabUrana/vivaSawaH/anacAhe/majabUrana/vivaSa_hokara/cAranAcAra/anwawogawvA/barabasa
wuranwa	Jatapata/catapata/PatAPata/wuranwa/wuranwa/wawkAla/avilamba/avilamba/POrana/POrana/KatAka_se/wawkRaNa/wadAka_se/wada_se/wapAka_se/awiSIGra/awiSIGrawaH/jalxa_se_jalxa/jalxI_se_jalxI/wada_se/hAWoM-hAWa/hAWoM_hAWa/hAWo-hAWa/hAWo_hAWa/Kata_se/Anana-PAnana_meM/AnanaPAnana_meM/siwAba/siwAbI/besAKwA/TahAkA/ikahAI/ikahAU
baDA-caDAkara	baDA-caDAkara/baDAcaDAkara
niyama_se	niyamiwawaH/niyama_se/niyamAnusAra/baxaswUra
PijUla	vyarWa/PajUla/PijUla/PijUla/anerA/yoM_hI/vqWA/apArWa/bAxa-havAI/bAxahavAI/ahewu/ahewuka/aviraWA
IsApUrva	IsApUrva/IsA_pUrva/IsavI_pUrva
PUtaPUta_kara	PUta-PUtakara/PUtaPUta_kara
SurU_meM	pahale_pahala/praWamawaH/sarva_praWama/sarvapraWama/SurU_meM/pahale-pahala/avvalana/pahile_pahala/pahile_pahala/AramBa_meM/AramBawaH/AramBawaH/pahale/SurU_meM/praWama/Axi_meM/praWamawaH/sarvapraWama/pUrva/SuruAwa_meM/SuruvAwa_meM/AramBa_meM/prAramBa_meM
yaWASakwi	yaWASakwi/Barasaka/yaWAsAXya/yaWAsamBava/kRamawAnusAra/yaWAkRama
hawabuxXi	hakkA-bakkA/BOMcakkA/kiMkarwavya-vimUDa/kiMkarwwavya-vimUDa/kiMkarwavyavimUDa/kiMkarwwavyavimUDa/hawabuxXi
WodA_sA	jarA/jarA/jarA-sA/jarA-sA/rawwiBara/WodA/WodA-sA/WodA_sA/wanika/yawkiMciw/nAmamAwra/leSamAwra/raFcamAwra/WodA_sA
weja	kasakara/joraxAra/weja/weja/wIvra/wejI_se/jora_se/wejI_se/jora_se/wIvrawA_se
sawagunA	sAwagunA/sawagunA
aXyakRara	akRaraSaH/SabxaSaH/aXyakRara
wanhA	akelA/akele/kevala/sirPa/mAwra/KAlI/KAlI/basa/nipata/mahaja/sirPa/wanhA/wanahA/ekAkI/ekameva/ekafga/ikelA
nisanxeha	niHsanxeha/nissanxeha/jarUra/jarUra/niHsanxeha/nissanxeha/nisanxeha/nisanxeha/binA_Saka/beSaka/bilkula/bilakula/yakInana/yakInana/avaSyameva/avaSya/alabawwA/bilASaka/aBarama/vASiMxA/bASiMxA/avasi/aviwarkika/asaMSaya/niSciwawaH/ikafka
isalie	isalie/isIlie/awaeva/awaH/lihAjA/lihAjA
ultA-paltA	ulatA-pulatA/ulatA_pulatA/ulatA-palatA/ultA-paltA/ultA-pultA/ultA_pultA
sAmane	sAmane/Age/samakRa/sammuKa/agre/anvakRa/aBimuKa/xarapeSa/Agala/AgalA/sIXe/sIXA/sAmane/sAmane
anupaxa	pICe-pICe/anupaxa/kaxama-ba_kaxama/bAxa/bAxa_meM/paScAw/uparAnwa/ananwara/paScAwa/uparAnwa/ananwara/pICe/uwwara/aWa/anupaxa/anvakRa
niHsvArWa	nisvArWa/niHsvArWa
joroM_se	jora-Sora_se/jora-Sora_se/joraSora_se/joraSora_se/joroM_se/joroM_se
jamakara	bahuwa/KUba/KUba/badA/jyAxA/jyAxA/aXika/kAPI/kAPI/kadA/jamakara/datakara/awyanwa/awyanwa/awyaXika/be-iMwahA/beiMwahA/bahuwa_aXika/bahuwa_hI/bepanAha/saKwa/saKwa/jamakara/mahA/nihAyawa/cUdAnwa/cUdAnwa/aByaXika/Agara
banisbawa	apekRAkqwa/wulanA_meM/apekRayA/mukAbale/mukAbale/banisbawa/se
viswArapUrvaka	viswArapUrvaka/viswAra_se
SAnwipUrvaka	SAnwipUrvaka/SAnwipUrvaka
joraSora_se	jora-Sora_se/jora-Sora_se/joraSora_se/joraSora_se/joroM_se/joroM_se
KuSI_se	svecCApUrvaka/icCA_se/KuSI_KuSI/KuSI_se/svecCayA/svecCawaH/prasannawApUrvaka/KuSI_KuSI/KuSI_KuSI/KuSI_se/KuSI_se/prasannawaH/saharRa/harRapUrvaka
sabere	sabere/savere/subaha/wadake/subaha-subaha/subaha_savere/jalxI/savere/sabere
nimeRa-mAwra	palaBara/pala-Bara/nimiRa-mAwra/nimeRa-mAwra
tanAtana	acCA/baDiyA/acCI_waraha/acCI_waraha_se/tanAtana
wInagunA	wigunA/wInagunA/wIna_gunA
vAkaI	vAkaI/vAkaI/vAswava_meM/hakIkawana/hakIkawana/xaraasala/asala_meM/sacamuca/saccI-muccI/saccI_muccI/sawyawaH/vaswuwaH
niSivAsara	hameSA/saxA/niwya/saxEva/niwya_prawi/sarvaxA/sarvaWA/haraxama/haravakwa/harasamaya/xina-rAwa/xinarAwa/xina_rAwa/rAwa-xina/rAwaxina/niSixina/nisa-vAsara/nisavAsara/niSivAsara/niranwara/niranwara/anavaXi/sarvaxEva/aharaha/pinnA/aharniSa/ahorAwra
ASu	jalxI/SIGra/SIGrawaH/avilambawaH/jalxa/acira/wUrNa/SiwAba/begi/avalambiwa/avalambiwa/jalxI_se/ASu/avilambiwa/avilambiwa
sarva_praWama	pahale_pahala/praWamawaH/sarva_praWama/sarvapraWama/SurU_meM/pahale-pahala/avvalana/pahile_pahala/pahile_pahala
aXikawara	prAyaH/akasara/aksara/aXikawara/aXikAMSawaH/jyAxAwara/bahuXA/AmawOra_para/AmawOra_se/aXikAMSawayA/prAyaSaH/anekaXA
hakkA-bakkA	hakkA-bakkA/BOMcakkA/kiMkarwavya-vimUDa/kiMkarwwavya-vimUDa/kiMkarwavyavimUDa/kiMkarwwavyavimUDa/hawabuxXi
acCI_waraha	BalI-BAzwi/BalI_BAzwi/BarapUra/BalIBAzwi/BalI-BAnwi/BalI_BAnwi/BalIBAnwi/sarvawoBAva/acCI_waraha/acCI_waraha/acCI_waraha_se/acCI_waraha/acCI_waraha_se/acCA/baDiyA/acCI_waraha/acCI_waraha_se/tanAtana/TIka/TIka_se/acCI_waraha/acCI_waraha_se/acCI_waraha/acCI_waraha_se
anerA	vyarWa/PajUla/PijUla/PijUla/anerA/yoM_hI/vqWA/apArWa/bAxa-havAI/bAxahavAI/ahewu/ahewuka/aviraWA
warIke_se	yukwipUrvaka/upAyawaH/upAya_se/jugawa_lagAkara/warakIba_se/warIke_se/warIke_se/warIke_se/warawIba_se/karIne_se/karIne_se/vyavasWApUrvaka/vyavasWiwawaH/karInAvAra/karInAvAra/viXipUrvaka/kAyaxe_se/Dafga_se/warIke_se/bawOra/bAkAyaxA/viXivaw/viXivawa
iha	yahAz/isa_jagaha/iwaH/iwa/iha/ihAz/ihavAz/IMGe/IhAz
Upara-nIce	Upara-nIce/aXoraXa/aXorXa/aXOrxXa
haswacAlana_xvArA	hAWa_se/hAWa_xvArA/haswacAliwa_Dafga_se/haswacAlana_xvArA
sawawa	lagAwAra/anavarawa/niranwara/niranwara/wAbadawoda/xanAxana/sawawa/XUAzXAra/ananwara/ananwara/avirAmawaH/aniSa/prawikRaNa/anukRaNa/XadAXada/avirawa/muwwasila/avicCinna/avicCexa/aviSrAnwa/aviSrAnwa/asarAra/aharaha/Asafga/Asafga/ikawAra
PalawaH	PalasvarUpa/pariNAma_svarUpa/pariNAmasvarUpa/pariNAmawaH/PalawaH/nawIjawana
jEse_wEse	kaTinAI_se/jEse_wEse/muSkila_se/bamuSkila/kaTinawaH/nITi
akasara	prAyaH/akasara/aksara/aXikawara/aXikAMSawaH/jyAxAwara/bahuXA/AmawOra_para/AmawOra_se/aXikAMSawayA/prAyaSaH/anekaXA
sahajawaH	AsAnI_se/sahajawA_se/saralawA_se/Kela_Kela_meM/sahajawaH/anEse
xinabaxina	xina-prawixina/xina-xina/xina-para-xina/xina-baxina/xina-ba_xina/xinaprawixina/xinaxina/xinabaxina/xinoM-xina/xinoMxina
viswAra_se	viswArapUrvaka/viswAra_se
anyexyu	anyexyu/anyaxA
icCAnusAra	icCAnusAra/icCAnukula/yaWecCa/yaWABIRta/yaWAvAFCiwa
mAPika	anusAra/mAPika/muwAbika/anukUla/muAPika/muAPika/muwAbika/aprawIRa
nirbAXa	nirbAXa/bAXArahiwa/akaNtaka
hAjira	peSa/hAjira/hAjira
pala_pala	prawikRaNa/pala_pala/pala-pala/prawipala/hara_kRaNa/kRaNa-kRaNa/haraGadI/hara_GadI/prawi_kRaNa/kRaNakRaNa/anukRaNa/CinaCina/Cina-Cina/AKana
kAnUnana	kAnUnana/kAnUnana/viXAnawaH
cAroM_waraPa	cAroM_ora/cAroM_waraPa/cAroM_waraPa/cahuz_ora/sarvawra/saBI_waraPa/cAroM_xiSAoM_meM/hara_jagaha/irxa-girxa
aprasannawApUrvaka	aprasannawApUrvaka/nArAjagIpUrvaka/nAKuSI_se/nArAjagIpUrvaka/nAKuSI_se
bIcoM-bIca	bIcobIca/bIcoMbIca/bIcoM-bIca/bIcama_bIca/bIcoM_bIca
anamiKa	takatakI_se/ekataka/tukura_tukura/taka-taka/animeRa/animiRa/animiKa/anamiKa/ikataka
nirxayawApUrvaka	nirxayawApUrvaka/nirxayawA_se/berahamI_se/bexarxI_se/krUrawApUrvaka/barbarawApUrvaka/kaTorawA_se/kadAI_se
maxxenajara	maxxenajara/maxxenajara
akRaraSaH	akRaraSaH/SabxaSaH/aXyakRara
kiMkarwavyavimUDa	hakkA-bakkA/BOMcakkA/kiMkarwavya-vimUDa/kiMkarwwavya-vimUDa/kiMkarwavyavimUDa/kiMkarwwavyavimUDa/hawabuxXi
xEvavaSa	acAnaka/ekAeka/sahasA/ekabAragI/ikabAragI/yakAyaka/akasmAwa/akasmAw/anAyAsa/xEvAw/xEvavaSa/Ocaka/aprawyASiwawaH/ApAwawaH/aFcakEM/agawyA/acaka/acAFcaka/acAkA/acAka/acAna/anAgawaH/anyAsa/nAgahAz/AcAna/ikahAI/ikahAU/iwwiPAkana/iwwiPAkana/iwwaPAkana/iwwaPAkana/ucakA/Ocaka
vargAkAra_meM	cOkora_meM/vargAkAra_meM
SuruAwa_meM	AramBa_meM/AramBawaH/AramBawaH/pahale/SurU_meM/praWama/Axi_meM/praWamawaH/sarvapraWama/pUrva/SuruAwa_meM/SuruvAwa_meM/AramBa_meM/prAramBa_meM
muwAbika	anusAra/mAPika/muwAbika/anukUla/muAPika/muAPika/muwAbika/aprawIRa
Axawana	svaBAvawaH/Axawana
cOkora_meM	cOkora_meM/vargAkAra_meM
palaBara	palaBara/pala-Bara/nimiRa-mAwra/nimeRa-mAwra
savismaya	AScaryapUrvaka/savismaya/sAScarya
TIka_se	sakuSala/kuSalawApUrvaka/kuSalapUrvaka/sahI_salAmawa/sahI-salAmawa/TIka-TAka/TIka_se/TIka-TAka_se/TIkaTAka/baKEra/baKEra/baKErIya/baKErIyawa/surakRiwawaH/TIka/TIka_se/acCI_waraha/acCI_waraha_se
Pira	xubArA/xobArA/Pira/Pira_se/punaH/eka_bAra_Pira/vApasa_se
Kullama-KullA	KuleAma/Kulakara/sareAma/sare-Ama/Kule-Ama/Kullama-KullA/KullamaKullA/dafke_kI_cota_para/sare_Ama/agupwawaH
kaBI_BI	kaBI_BI
anyawaH	anyawaH/anyawaH
Age-pICe	AgepICe/Age_pICe/Age-pICe/pUrvApara
petaBara	Barapeta/petaBara
AgrahapUrvaka	AgrahapUrvaka/Agraha_se
isI_bIca	iwane_meM/isa_bIca/isI_bIca/isa_xOrAna/isa_xaramyAna
icCApUrvaka	jAna-bUJakara/jAnabUJakara/jAnabUJa_kara/amaxana/icCApUrvaka/mawipUrva/irAxawana
SIGrawaH	jalxI/SIGra/SIGrawaH/avilambawaH/jalxa/acira/wUrNa/SiwAba/begi/avalambiwa/avalambiwa/jalxI_se/ASu/avilambiwa/avilambiwa
pACe	pICe/paScawaH/pACe/pqRTawaH/arvAka
harRapUrvaka	prasannawApUrvaka/KuSI_KuSI/KuSI_KuSI/KuSI_se/KuSI_se/prasannawaH/saharRa/harRapUrvaka
prAyaH	aXikawaH/aXikAMSawaH/prAyaH/aXikAMSawayA/prAyaH/akasara/aksara/aXikawara/aXikAMSawaH/jyAxAwara/bahuXA/AmawOra_para/AmawOra_se/aXikAMSawayA/prAyaSaH/anekaXA
ikataka	takatakI_se/ekataka/tukura_tukura/taka-taka/animeRa/animiRa/animiKa/anamiKa/ikataka
amaxana	jAna-bUJakara/jAnabUJakara/jAnabUJa_kara/amaxana/icCApUrvaka/mawipUrva/irAxawana
Asawe	XIre/XIme/hOle/Ahiswe/AhiswA/Ahiswe_se/AhiswA_se/Asawe/Aswe
wapAka_se	Jatapata/catapata/PatAPata/wuranwa/wuranwa/wawkAla/avilamba/avilamba/POrana/POrana/KatAka_se/wawkRaNa/wadAka_se/wada_se/wapAka_se/awiSIGra/awiSIGrawaH/jalxa_se_jalxa/jalxI_se_jalxI/wada_se/hAWoM-hAWa/hAWoM_hAWa/hAWo-hAWa/hAWo_hAWa/Kata_se/Anana-PAnana_meM/AnanaPAnana_meM/siwAba/siwAbI/besAKwA/TahAkA/ikahAI/ikahAU
vAkaI	vAkaI/vAkaI/vAswava_meM/hakIkawana/hakIkawana/xaraasala/asala_meM/sacamuca/saccI-muccI/saccI_muccI/sawyawaH/vaswuwaH
meharabAnI_karake	kqpayA/kqpApUrvaka/kqpA_pUrvaka/kqpA_karake/meharabAnI_karake
anEse	AsAnI_se/sahajawA_se/saralawA_se/Kela_Kela_meM/sahajawaH/anEse/anEse
hOle-hOle	XIre-XIre/XIre_XIre/Ahiswe-Ahiswe/AhiswA-AhiswA/hOle-hOle/hole-hole/raPwA-raPwA/alpaSaH
sarvaWA	hameSA/saxA/niwya/saxEva/niwya_prawi/sarvaxA/sarvaWA/haraxama/haravakwa/harasamaya/xina-rAwa/xinarAwa/xina_rAwa/rAwa-xina/rAwaxina/niSixina/nisa-vAsara/nisavAsara/niSivAsara/niranwara/niranwara/anavaXi/sarvaxEva/aharaha/pinnA/aharniSa/ahorAwra
yaWAvawa	yaWAvaw/yaWAvawa
bahuwa_aXika	awyanwa/awyanwa/awyaXika/be-iMwahA/beiMwahA/bahuwa_aXika/bahuwa_hI/bepanAha/saKwa/saKwa/jamakara/mahA/nihAyawa/cUdAnwa/cUdAnwa/aByaXika/Agara
bilASaka	niHsanxeha/nissanxeha/jarUra/jarUra/niHsanxeha/nissanxeha/nisanxeha/nisanxeha/binA_Saka/beSaka/bilkula/bilakula/yakInana/yakInana/avaSyameva/avaSya/alabawwA/bilASaka/aBarama/vASiMxA/bASiMxA/avasi/aviwarkika/asaMSaya/niSciwawaH/ikafka
sarvaxEva	hameSA/saxA/niwya/saxEva/niwya_prawi/sarvaxA/sarvaWA/haraxama/haravakwa/harasamaya/xina-rAwa/xinarAwa/xina_rAwa/rAwa-xina/rAwaxina/niSixina/nisa-vAsara/nisavAsara/niSivAsara/niranwara/niranwara/anavaXi/sarvaxEva/aharaha/pinnA/aharniSa/ahorAwra
aswa-vyaswa	wiwara-biwara/aswa-vyaswa/Cinna-Binna/bewarawIba/aswavyaswa/_avyavasWiwa
yaWAniyama	niyamAnusAra/yaWAniyama/bA-jAbwA
nArAjagIpUrvaka	aprasannawApUrvaka/nArAjagIpUrvaka/nAKuSI_se/nArAjagIpUrvaka/nAKuSI_se
prawi_kRaNa	prawikRaNa/pala_pala/pala-pala/prawipala/hara_kRaNa/kRaNa-kRaNa/haraGadI/hara_GadI/prawi_kRaNa/kRaNakRaNa/anukRaNa/CinaCina/Cina-Cina/AKana
ekameva	akelA/akele/kevala/sirPa/mAwra/KAlI/KAlI/basa/nipata/mahaja/sirPa/wanhA/wanahA/ekAkI/ekameva/ekafga/ikelA
rojAnA	prawixina/haraxina/niwya/hararoja/roja/niwa/roja/rojAnA/rojAnA/anuxina/niwyaprawi/anuxivasa/aharaha
TasATasa	TasATasa/TuzsATuzsa/KacAKaca/TusATusa
awiSIGra	Jatapata/catapata/PatAPata/wuranwa/wuranwa/wawkAla/avilamba/avilamba/POrana/POrana/KatAka_se/wawkRaNa/wadAka_se/wada_se/wapAka_se/awiSIGra/awiSIGrawaH/jalxa_se_jalxa/jalxI_se_jalxI/wada_se/hAWoM-hAWa/hAWoM_hAWa/hAWo-hAWa/hAWo_hAWa/Kata_se/Anana-PAnana_meM/AnanaPAnana_meM/siwAba/siwAbI/besAKwA/TahAkA/ikahAI/ikahAU
anakarIba	anxAjana/anxAjana/anxAjana/anxAjana/lagaBaga/wakarIbana/wakarIbana/karIba/karIba/karIbakarIba/karIbana/karIbakarIba/karIbana/anumAnawaH/anakarIba/anakarIba/waKamInana/anxAja_se/ukavAz
jabarana	balapUrvaka/barabasa/jabaraxaswI/jabaraxaswI/jabarana/jabarana/barajorI
sPUrwipUrvaka	sPUrwipUrvaka/cuswI_se/PurwI_se/muswExI_se
kaBI-kaBI	kaBIkaBI/kaBIkaBAra/yaxAkaxA/kaBI-kaBI/kaBI-kaBAra/yaxA-kaxA/vakwan-POvakwan
svayaM	svayaM/svawaH/Kuxa/Kuxa/Apa/ApahI/apaneApa/Kuxa_hI/sAkRAw/sAkRAwa/asAlawana/AparUpa
hasba-e-mAmUla	hasbemAmUla/hasbe-mAmUla/hasba-e-mAmUla/hameSA_kI_waraha
sawkArapUrvaka	sawkArapUrvaka/sAxara/sasammAna/Axara_sahiwa
ke_BIwara	ke_anxara/ke_anxara/ke_BIwara/meM
vASiMxA	niHsanxeha/nissanxeha/jarUra/jarUra/niHsanxeha/nissanxeha/nisanxeha/nisanxeha/binA_Saka/beSaka/bilkula/bilakula/yakInana/yakInana/avaSyameva/avaSya/alabawwA/bilASaka/aBarama/vASiMxA/bASiMxA/avasi/aviwarkika/asaMSaya/niSciwawaH/ikafka
viXivaw	viXipUrvaka/kAyaxe_se/Dafga_se/warIke_se/bawOra/bAkAyaxA/viXivaw/viXivawa
asAvaXAnawaH	asAvaXAnawaH/asAvaXAnI_se/XyAnahInawaH/lAparavAhI_se
yakInana	niHsanxeha/nissanxeha/jarUra/jarUra/niHsanxeha/nissanxeha/nisanxeha/nisanxeha/binA_Saka/beSaka/bilkula/bilakula/yakInana/yakInana/avaSyameva/avaSya/alabawwA/bilASaka/aBarama/vASiMxA/bASiMxA/avasi/aviwarkika/asaMSaya/niSciwawaH/ikafka
XIme	XIre/XIme/hOle/Ahiswe/AhiswA/Ahiswe_se/AhiswA_se/Asawe/Aswe
haswacAliwa_Dafga_se	hAWa_se/hAWa_xvArA/haswacAliwa_Dafga_se/haswacAlana_xvArA
kqpA_pUrvaka	kqpayA/kqpApUrvaka/kqpA_pUrvaka/kqpA_karake/meharabAnI_karake
kahuz	kahIM/kahUz/kahuz/kahIM/kahUz/kahuz
nihAyawa	awyanwa/awyanwa/awyaXika/be-iMwahA/beiMwahA/bahuwa_aXika/bahuwa_hI/bepanAha/saKwa/saKwa/jamakara/mahA/nihAyawa/cUdAnwa/cUdAnwa/aByaXika/Agara
vicAriwawaH	soca-vicArakara/samaJa-bUJakara/vicArapUrvaka/soca-samaJakara/soca_vicAra_kara/samaJa_bUJa_kara/soca_samaJa_kara/vicAriwawaH
beJiJaka	nisafkoca/niHsafkoca/nissafkoca/beXadaka/safkocahInawaH/beJiJaka/beKataka/beKatake/behicaka
aXOrxXa	Upara-nIce/aXoraXa/aXorXa/aXOrxXa
sapawnIka	sapawnIka
awiSIGrawaH	Jatapata/catapata/PatAPata/wuranwa/wuranwa/wawkAla/avilamba/avilamba/POrana/POrana/KatAka_se/wawkRaNa/wadAka_se/wada_se/wapAka_se/awiSIGra/awiSIGrawaH/jalxa_se_jalxa/jalxI_se_jalxI/wada_se/hAWoM-hAWa/hAWoM_hAWa/hAWo-hAWa/hAWo_hAWa/Kata_se/Anana-PAnana_meM/AnanaPAnana_meM/siwAba/siwAbI/besAKwA/TahAkA/ikahAI/ikahAU
aBarama	niHsanxeha/nissanxeha/jarUra/jarUra/niHsanxeha/nissanxeha/nisanxeha/nisanxeha/binA_Saka/beSaka/bilkula/bilakula/yakInana/yakInana/avaSyameva/avaSya/alabawwA/bilASaka/aBarama/vASiMxA/bASiMxA/avasi/aviwarkika/asaMSaya/niSciwawaH/ikafka
viSvAsapUrvaka	viSvAsa_ke_sAWa/viSvasanIyawA_se/viSvAsapUrvaka
AjU-bAjU	Asa-pAsa/AsapAsa/agala-bagala/agala-bagala/AjU-bAjU/irxa-girxa/adosa-padosa/pAsa-padosa/pAsa_padosa
wirapata	wiraCA/wiryaka/AdA/teDA/bAzkA/wirapata
PilahAla	PilahAla/PilahAla/aba/varwamAna_meM/Aja-kala/Ajakala/Aja_kala/AjakAla/ina_xinoM/isa_samaya/samprawi/aBI/PilahAla/PilahAla/isa_samaya/aba/aWa/aXunA/samprawi/samprawi/aBU/aBE
wale	wale/nIce
apekRAkqwa	apekRAkqwa/wulanA_meM/apekRayA/mukAbale/mukAbale/banisbawa/se
vApasa_se	xubArA/xobArA/Pira/Pira_se/punaH/eka_bAra_Pira/vApasa_se
prawiSawa	prawiSawa/PIsaxI/PIsaxI/paraseMta
bahuXA	prAyaH/akasara/aksara/aXikawara/aXikAMSawaH/jyAxAwara/bahuXA/AmawOra_para/AmawOra_se/aXikAMSawayA/prAyaSaH/anekaXA
niHsanxeha	niHsanxeha/nissanxeha/jarUra/jarUra/niHsanxeha/nissanxeha/nisanxeha/nisanxeha/binA_Saka/beSaka/bilkula/bilakula/yakInana/yakInana/avaSyameva/avaSya/alabawwA/bilASaka/aBarama/vASiMxA/bASiMxA/avasi/aviwarkika/asaMSaya/niSciwawaH/ikafka
PatAPata	Jatapata/catapata/PatAPata/wuranwa/wuranwa/wawkAla/avilamba/avilamba/POrana/POrana/KatAka_se/wawkRaNa/wadAka_se/wada_se/wapAka_se/awiSIGra/awiSIGrawaH/jalxa_se_jalxa/jalxI_se_jalxI/wada_se/hAWoM-hAWa/hAWoM_hAWa/hAWo-hAWa/hAWo_hAWa/Kata_se/Anana-PAnana_meM/AnanaPAnana_meM/siwAba/siwAbI/besAKwA/TahAkA/ikahAI/ikahAU
kahIM	kahIM/kahUz/kahuz/kahIM/kahUz/kahuz/kahIM
XyAnahInawaH	asAvaXAnawaH/asAvaXAnI_se/XyAnahInawaH/lAparavAhI_se
kramaSaH	kramaSaH/kramAnusAra/yaWAkrama/silasilevAra/bArI-bArI_se/kramavAra/warawIbavAra/ayugapaxa/alpaSaH
joraxAra	kasakara/joraxAra/weja/weja/wIvra/wejI_se/jora_se/wejI_se/jora_se/wIvrawA_se
Ahiswe_se	XIre/XIme/hOle/Ahiswe/AhiswA/Ahiswe_se/AhiswA_se/Asawe/Aswe
KuxabaKuxa	svawaH/apaneApa/Kuxa-ba-Kuxa/KuxabaKuxa/Kuxa-ba-Kuxa/KuxabaKuxa
raFcamAwra	nAmamAwra/leSamAwra/raFcamAwra/WodA_sA
waxauparAnwa	wawapaScAwa/waxananwara/waxauparAnwa/waxoparAnwa/waxanwara/waxananwara/waxuparAnwa/waxuparAnwa/waxoparAnwa/waxoparAnwa/waxanwara
usI_waraha	vEse/vEsA/usI_waraha/usa_waraha/iva
TahAkA	Jatapata/catapata/PatAPata/wuranwa/wuranwa/wawkAla/avilamba/avilamba/POrana/POrana/KatAka_se/wawkRaNa/wadAka_se/wada_se/wapAka_se/awiSIGra/awiSIGrawaH/jalxa_se_jalxa/jalxI_se_jalxI/wada_se/hAWoM-hAWa/hAWoM_hAWa/hAWo-hAWa/hAWo_hAWa/Kata_se/Anana-PAnana_meM/AnanaPAnana_meM/siwAba/siwAbI/besAKwA/TahAkA/ikahAI/ikahAU
mUlawaH	mUlawaH
abalaga	aba_waka/aBI_waka/Aja_waka/abawaka/aBIwaka/Ajawaka/ajahuz/ajahUz/ajo/ajOM/abalaga
punaH	xubArA/xobArA/Pira/Pira_se/punaH/eka_bAra_Pira/vApasa_se
jIvanaBara	mqwyuparyanwa/AjIvana/wAumra/umraBara/jiMxagIBara/jiMxagIBara/jIvanaBara/AmaraNa/anwima_xama_waka/Ajanma/jIvanaparyanwa/jIvanaBara
IMGe	yahAz/isa_jagaha/iwaH/iwa/iha/ihAz/ihavAz/IMGe/IhAz
waba	waba/usa_samaya/usa_vakwa/waba
Ara-pAra	Ara-pAra/ArapAra
Kuxa	svayaM/svawaH/Kuxa/Kuxa/Apa/ApahI/apaneApa/Kuxa_hI/sAkRAw/sAkRAwa/asAlawana/AparUpa
wiraCA	wiraCA/wiryaka/AdA/teDA/bAzkA/wirapata
mukAbale	apekRAkqwa/wulanA_meM/apekRayA/mukAbale/mukAbale/banisbawa/se
iwwaPAkana	acAnaka/ekAeka/sahasA/ekabAragI/ikabAragI/yakAyaka/akasmAwa/akasmAw/anAyAsa/xEvAw/xEvavaSa/Ocaka/aprawyASiwawaH/ApAwawaH/aFcakEM/agawyA/acaka/acAFcaka/acAkA/acAka/acAna/anAgawaH/anyAsa/nAgahAz/AcAna/ikahAI/ikahAU/iwwiPAkana/iwwiPAkana/iwwaPAkana/iwwaPAkana/ucakA/Ocaka/saMyogavaSa/iwwiPAkana/iwwiPAkana/iwwaPAkana/iwwaPAkana/saMyogavaSAw
nOgunA	nOgunA/navagunA
rima-Jima	rimaJima/rimaJima-rimaJima/rima-Jima
hasbemAmUla	hasbemAmUla/hasbe-mAmUla/hasba-e-mAmUla/hameSA_kI_waraha
aXo_xiSA_meM	nIce/aXaH/nimnawaH/aXo_xiSA_meM
AKana	prawikRaNa/pala_pala/pala-pala/prawipala/hara_kRaNa/kRaNa-kRaNa/haraGadI/hara_GadI/prawi_kRaNa/kRaNakRaNa/anukRaNa/CinaCina/Cina-Cina/AKana
xuganA	xugunA/xUnA/xogunA/xuganA/xviguNa/xviguNiwa
Kule-Ama	KuleAma/Kulakara/sareAma/sare-Ama/Kule-Ama/Kullama-KullA/KullamaKullA/dafke_kI_cota_para/sare_Ama/agupwawaH
vyarWa	vyarWa/PajUla/PijUla/PijUla/anerA/yoM_hI/vqWA/apArWa/bAxa-havAI/bAxahavAI/ahewu/ahewuka/aviraWA
xina-para-xina	xina-prawixina/xina-xina/xina-para-xina/xina-baxina/xina-ba_xina/xinaprawixina/xinaxina/xinabaxina/xinoM-xina/xinoMxina
acira	jalxI/SIGra/SIGrawaH/avilambawaH/jalxa/acira/wUrNa/SiwAba/begi/avalambiwa/avalambiwa/jalxI_se/ASu/avilambiwa/avilambiwa
bAXArahiwa	nirbAXa/bAXArahiwa/akaNtaka
ukurU	ukadUz/ukadU/ukadUz/ukadU/ukurU
jalxI_se_jalxI	Jatapata/catapata/PatAPata/wuranwa/wuranwa/wawkAla/avilamba/avilamba/POrana/POrana/KatAka_se/wawkRaNa/wadAka_se/wada_se/wapAka_se/awiSIGra/awiSIGrawaH/jalxa_se_jalxa/jalxI_se_jalxI/wada_se/hAWoM-hAWa/hAWoM_hAWa/hAWo-hAWa/hAWo_hAWa/Kata_se/Anana-PAnana_meM/AnanaPAnana_meM/siwAba/siwAbI/besAKwA/TahAkA/ikahAI/ikahAU
varwamAna_meM	PilahAla/PilahAla/aba/varwamAna_meM/Aja-kala/Ajakala/Aja_kala/AjakAla/ina_xinoM/isa_samaya/samprawi
sahI-salAmawa	sakuSala/kuSalawApUrvaka/kuSalapUrvaka/sahI_salAmawa/sahI-salAmawa/TIka-TAka/TIka_se/TIka-TAka_se/TIkaTAka/baKEra/baKEra/baKErIya/baKErIyawa/surakRiwawaH
baxaswUra	niyamiwawaH/niyama_se/niyamAnusAra/baxaswUra/paramparAnusAra/baxaswUra
iwarewara	paraspara/Apasa_meM/eka_xUsare_se/iwarewara
jabaraxaswI	balapUrvaka/barabasa/jabaraxaswI/jabaraxaswI/jabarana/jabarana/barajorI
Jatake_se	Jatake_se/Jatake_ke_sAWa
apaneApa	svayaM/svawaH/Kuxa/Kuxa/Apa/ApahI/apaneApa/Kuxa_hI/sAkRAw/sAkRAwa/asAlawana/AparUpa/svawaH/apaneApa/Kuxa-ba-Kuxa/KuxabaKuxa/Kuxa-ba-Kuxa/KuxabaKuxa
bewarawIba	wiwara-biwara/aswa-vyaswa/Cinna-Binna/bewarawIba/aswavyaswa/_avyavasWiwa
KAlI	akelA/akele/kevala/sirPa/mAwra/KAlI/KAlI/basa/nipata/mahaja/sirPa/wanhA/wanahA/ekAkI/ekameva/ekafga/ikelA
aSiRtawaH	asaByawaH/aSiRtawaH/SiRtAcArahInawaH
pahale_se_hI	pahale_se/pUrvawaH/pahale_se_hI
najIka	pAsa_meM/najaxIka/najaxIka/nikata_meM/karIba_meM/samIpa/nikata/pAsa/karIba/karIba/sannikata/najIka/muwwasila/arvAka/avixUra/Are/AsapAsa/Asa-pAsa
KAsawOra_se	viSeRakara/KAsakara/KAsa_wOra_para/KAsa_wOra_se/KAsawOra_para/KAsawOra_se/KAsawOra_para/KAsawOra_se/KAsakara/viSeRawaH/viSiRtawaH/muKyawaH/viSeRa_rUpa_se
paryApwa	paryApwa/kAPI/kAPI/yaWeRta/alam/alaM
jagaha-jagaha_para	jagaha-jagaha_para
BI	BI/BI
sirPa	akelA/akele/kevala/sirPa/mAwra/KAlI/KAlI/basa/nipata/mahaja/sirPa/wanhA/wanahA/ekAkI/ekameva/ekafga/ikelA
pUrNarupeNa	bilkula/bilakula/ekaxama/nipata/sarAsara/TIka/niwAnwa/niwAnwa/pUrNawaH/pUrI_waraha_se/pUrNawayA/sampUrNawaH/sampUrNawayA/pUrNarupeNa/AmUlacUla/Sawa-prawiSawa
barajorI	balapUrvaka/barabasa/jabaraxaswI/jabaraxaswI/jabarana/jabarana/barajorI
wUrNa	jalxI/SIGra/SIGrawaH/avilambawaH/jalxa/acira/wUrNa/SiwAba/begi/avalambiwa/avalambiwa/jalxI_se/ASu/avilambiwa/avilambiwa
WodA_WodA	alpawaH/WodA-WodA/WodA_WodA/alpaSaH
kRamawAnusAra	yaWASakwi/Barasaka/yaWAsAXya/yaWAsamBava/kRamawAnusAra/yaWAkRama
uxvignawApUrvaka	ciMwiwawaH/uxvignawaH/uxvignawApUrvaka
bina_mAzge	binamAzge/bina_mAzge/anamAzge/ayAciwawaH
karIbana	anxAjana/anxAjana/anxAjana/anxAjana/lagaBaga/wakarIbana/wakarIbana/karIba/karIba/karIbakarIba/karIbana/karIbakarIba/karIbana/anumAnawaH/anakarIba/anakarIba/waKamInana/anxAja_se/ukavAz
aBIwaka	aba_waka/aBI_waka/Aja_waka/abawaka/aBIwaka/Ajawaka/ajahuz/ajahUz/ajo/ajOM/abalaga
yAciwawaH	mAzgakara/yAciwawaH
praWama	AramBa_meM/AramBawaH/AramBawaH/pahale/SurU_meM/praWama/Axi_meM/praWamawaH/sarvapraWama/pUrva/SuruAwa_meM/SuruvAwa_meM/AramBa_meM/prAramBa_meM
sareSAma	sareSAma
xinaprawixina	xina-prawixina/xina-xina/xina-para-xina/xina-baxina/xina-ba_xina/xinaprawixina/xinaxina/xinabaxina/xinoM-xina/xinoMxina
mqwyuparyanwa	mqwyuparyanwa/AjIvana/wAumra/umraBara/jiMxagIBara/jiMxagIBara/jIvanaBara/AmaraNa/anwima_xama_waka
bAzkA	wiraCA/wiryaka/AdA/teDA/bAzkA/wirapata
samUhawaH	samUhawaH/sAmUhika_rUpa_se
KAsa_wOra_para	viSeRakara/KAsakara/KAsa_wOra_para/KAsa_wOra_se/KAsawOra_para/KAsawOra_se/KAsawOra_para/KAsawOra_se/KAsakara/viSeRawaH/viSiRtawaH/muKyawaH/viSeRa_rUpa_se
arvAka	pAsa_meM/najaxIka/najaxIka/nikata_meM/karIba_meM/samIpa/nikata/pAsa/karIba/karIba/sannikata/najIka/muwwasila/arvAka/avixUra/Are/AsapAsa/Asa-pAsa/pICe/paScawaH/pACe/pqRTawaH/arvAka
AgepICe	AgepICe/Age_pICe/Age-pICe/pUrvApara
samprawi	PilahAla/PilahAla/aba/varwamAna_meM/Aja-kala/Ajakala/Aja_kala/AjakAla/ina_xinoM/isa_samaya/samprawi/aBI/PilahAla/PilahAla/isa_samaya/aba/aWa/aXunA/samprawi/samprawi/aBU/aBE
niwyaprawi	prawixina/haraxina/niwya/hararoja/roja/niwa/roja/rojAnA/rojAnA/anuxina/niwyaprawi/anuxivasa/aharaha
aspaRtawaH	aspaRtawaH/sanxigXawaH
SAnwa	cupacApa/cupa/mOna/SAnwa/SAnwa/KAmoSI_se/KAmoSI_se/niSSabxa/avAka/avAk/bina_bole/mOnawaH
anxAjana	anxAjana/anxAjana/anxAjana/anxAjana/lagaBaga/wakarIbana/wakarIbana/karIba/karIba/karIbakarIba/karIbana/karIbakarIba/karIbana/anumAnawaH/anakarIba/anakarIba/waKamInana/anxAja_se/ukavAz
acAnaka	acAnaka/ekAeka/sahasA/ekabAragI/ikabAragI/yakAyaka/akasmAwa/akasmAw/anAyAsa/xEvAw/xEvavaSa/Ocaka/aprawyASiwawaH/ApAwawaH/aFcakEM/agawyA/acaka/acAFcaka/acAkA/acAka/acAna/anAgawaH/anyAsa/nAgahAz/AcAna/ikahAI/ikahAU/iwwiPAkana/iwwiPAkana/iwwaPAkana/iwwaPAkana/ucakA/Ocaka
parAXInawaH	parAXInawaH/aXInawA_meM/paravaSawaH
karIbakarIba	anxAjana/anxAjana/anxAjana/anxAjana/lagaBaga/wakarIbana/wakarIbana/karIba/karIba/karIbakarIba/karIbana/karIbakarIba/karIbana/anumAnawaH/anakarIba/anakarIba/waKamInana/anxAja_se/ukavAz
BalIBAnwi	BalI-BAzwi/BalI_BAzwi/BarapUra/BalIBAzwi/BalI-BAnwi/BalI_BAnwi/BalIBAnwi/sarvawoBAva/acCI_waraha
peSa	peSa/hAjira/hAjira
iwaH	iXara/isa_ora/yahAz_para/iwaH/iwa/iwE/iwWe/yahAz/isa_jagaha/iwaH/iwa/iha/ihAz/ihavAz/IMGe/IhAz
subaha_savere	sabere/savere/subaha/wadake/subaha-subaha/subaha_savere
AkarNa	AkarNa
SOkiyA	SOkiyA
uwana	uXara/usa_ora/pare/uwa/uwana
pAsa_meM	pAsa_meM/najaxIka/najaxIka/nikata_meM/karIba_meM/samIpa/nikata/pAsa/karIba/karIba/sannikata/najIka/muwwasila/arvAka/avixUra/Are/AsapAsa/Asa-pAsa
BalI-BAzwi	BalI-BAzwi/BalI_BAzwi/BarapUra/BalIBAzwi/BalI-BAnwi/BalI_BAnwi/BalIBAnwi/sarvawoBAva/acCI_waraha
usI_samaya	waBI/waba_hI/usI_samaya/usI_GadI
bagatuta	bagaCuta/bagatuta
sarasarI	sarasarI
sAmAnyawayA	sAmAnyawaH/sAmAnyawayA/sAXAraNawaH/sAXAraNawayA/amUmana/umUmana
kAPI	bahuwa/KUba/KUba/badA/jyAxA/jyAxA/aXika/kAPI/kAPI/kadA/jamakara/datakara/paryApwa/kAPI/kAPI/yaWeRta/alam/alaM
waxananwara	wawapaScAwa/waxananwara/waxauparAnwa/waxoparAnwa/waxanwara/waxananwara/waxuparAnwa/waxuparAnwa/waxoparAnwa/waxoparAnwa/waxanwara
aba_waka	aba_waka/aBI_waka/Aja_waka/abawaka/aBIwaka/Ajawaka/ajahuz/ajahUz/ajo/ajOM/abalaga
aXaH	nIce/aXaH/nimnawaH/aXo_xiSA_meM
galawa_samaya_para	asamaya/bevakwa/bevakwa/galawa_samaya_para/galawa_samaya_para/bemOke
awyanwa	awyanwa/awyanwa/awyaXika/be-iMwahA/beiMwahA/bahuwa_aXika/bahuwa_hI/bepanAha/saKwa/saKwa/jamakara/mahA/nihAyawa/cUdAnwa/cUdAnwa/aByaXika/Agara
kqpA_kara_ke	xayApUrvaka/kqpA_kara_ke/kqpApUrvaka/xayA_se/barAe_meharabAnI
Age_kI_ora	Age-Age/Age_kI_ora/sabase_pahale
ukadUz	ukadUz/ukadU/ukadUz/ukadU/ukurU
waxanwara	wawapaScAwa/waxananwara/waxauparAnwa/waxoparAnwa/waxanwara/waxananwara/waxuparAnwa/waxuparAnwa/waxoparAnwa/waxoparAnwa/waxanwara
anwarjAnu	anwarjAnu/anwarjAnu
saxeha	saxeha/saSarIra
catapata	Jatapata/catapata/PatAPata/wuranwa/wuranwa/wawkAla/avilamba/avilamba/POrana/POrana/KatAka_se/wawkRaNa/wadAka_se/wada_se/wapAka_se/awiSIGra/awiSIGrawaH/jalxa_se_jalxa/jalxI_se_jalxI/wada_se/hAWoM-hAWa/hAWoM_hAWa/hAWo-hAWa/hAWo_hAWa/Kata_se/Anana-PAnana_meM/AnanaPAnana_meM/siwAba/siwAbI/besAKwA/TahAkA/ikahAI/ikahAU
AScaryapUrvaka	AScaryapUrvaka/savismaya/sAScarya
Kuxa_hI	svayaM/svawaH/Kuxa/Kuxa/Apa/ApahI/apaneApa/Kuxa_hI/sAkRAw/sAkRAwa/asAlawana/AparUpa
beiMwahA	awyanwa/awyanwa/awyaXika/be-iMwahA/beiMwahA/bahuwa_aXika/bahuwa_hI/bepanAha/saKwa/saKwa/jamakara/mahA/nihAyawa/cUdAnwa/cUdAnwa/aByaXika/Agara
samAnwara	samAnwara/samAnAnwara/samAnwara/samAnAnwara
hAWoM-hAWa	Jatapata/catapata/PatAPata/wuranwa/wuranwa/wawkAla/avilamba/avilamba/POrana/POrana/KatAka_se/wawkRaNa/wadAka_se/wada_se/wapAka_se/awiSIGra/awiSIGrawaH/jalxa_se_jalxa/jalxI_se_jalxI/wada_se/hAWoM-hAWa/hAWoM_hAWa/hAWo-hAWa/hAWo_hAWa/Kata_se/Anana-PAnana_meM/AnanaPAnana_meM/siwAba/siwAbI/besAKwA/TahAkA/ikahAI/ikahAU
kaTinawaH	kaTinAI_se/jEse_wEse/muSkila_se/bamuSkila/kaTinawaH/nITi
avirawa	lagAwAra/anavarawa/niranwara/niranwara/wAbadawoda/xanAxana/sawawa/XUAzXAra/ananwara/ananwara/avirAmawaH/aniSa/prawikRaNa/anukRaNa/XadAXada/avirawa/muwwasila/avicCinna/avicCexa/aviSrAnwa/aviSrAnwa/asarAra/aharaha/Asafga/Asafga/ikawAra
sarapata	sarapata
avalambiwa	jalxI/SIGra/SIGrawaH/avilambawaH/jalxa/acira/wUrNa/SiwAba/begi/avalambiwa/avalambiwa/jalxI_se/ASu/avilambiwa/avilambiwa
xarSanArWa	xarSanArWa
avilambiwa	jalxI/SIGra/SIGrawaH/avilambawaH/jalxa/acira/wUrNa/SiwAba/begi/avalambiwa/avalambiwa/jalxI_se/ASu/avilambiwa/avilambiwa
jAzca_paraKakara	jAzca_paraKakara/jAzca_paraKa_kara
amUmana	sAmAnyawaH/sAmAnyawayA/sAXAraNawaH/sAXAraNawayA/amUmana/umUmana
karInAvAra	warIke_se/warIke_se/warawIba_se/karIne_se/karIne_se/vyavasWApUrvaka/vyavasWiwawaH/karInAvAra/karInAvAra
ucakA	acAnaka/ekAeka/sahasA/ekabAragI/ikabAragI/yakAyaka/akasmAwa/akasmAw/anAyAsa/xEvAw/xEvavaSa/Ocaka/aprawyASiwawaH/ApAwawaH/aFcakEM/agawyA/acaka/acAFcaka/acAkA/acAka/acAna/anAgawaH/anyAsa/nAgahAz/AcAna/ikahAI/ikahAU/iwwiPAkana/iwwiPAkana/iwwaPAkana/iwwaPAkana/ucakA/Ocaka
pravAha_kI_ora	pravAha_kI_xiSA_meM/pravAha_kI_ora
aBimAnapUrvaka	aBimAnapUrvaka/aBimAna_se/sagarva/sABimAna
SAlInawaH	SiRtawaH/saByawaH/bAsaUra/SAlInawaH/SiRtAcArapUrvaka/salIke_se
yaxA-kaxA	kaBIkaBI/kaBIkaBAra/yaxAkaxA/kaBI-kaBI/kaBI-kaBAra/yaxA-kaxA/vakwan-POvakwan
vilambawaH	vilambawaH/aSIGrawaH/xerI_se/vilambapUrvaka/xera_meM
sirPa	akelA/akele/kevala/sirPa/mAwra/KAlI/KAlI/basa/nipata/mahaja/sirPa/wanhA/wanahA/ekAkI/ekameva/ekafga/ikelA
KAsawOra_para	viSeRakara/KAsakara/KAsa_wOra_para/KAsa_wOra_se/KAsawOra_para/KAsawOra_se/KAsawOra_para/KAsawOra_se/KAsakara/viSeRawaH/viSiRtawaH/muKyawaH/viSeRa_rUpa_se
corI_Cipe	gupwawaH/gupacupa_rUpa_se/corI_Cipe
BUwa_kAla_meM	awIwa_meM/pahale/BUwa_meM/BUwa_kAla_meM/pICe/piCale_xinoM_meM
samIpa	pAsa_meM/najaxIka/najaxIka/nikata_meM/karIba_meM/samIpa/nikata/pAsa/karIba/karIba/sannikata/najIka/muwwasila/arvAka/avixUra/Are/AsapAsa/Asa-pAsa
prawipala	prawikRaNa/pala_pala/pala-pala/prawipala/hara_kRaNa/kRaNa-kRaNa/haraGadI/hara_GadI/prawi_kRaNa/kRaNakRaNa/anukRaNa/CinaCina/Cina-Cina/AKana
Age-Age	Age-Age/Age_kI_ora/sabase_pahale
wigunA	wigunA/wInagunA/wIna_gunA
beKatake	niSciMwawaH/ciMwAhInawaH/beKatake/nisafkoca/niHsafkoca/nissafkoca/beXadaka/safkocahInawaH/beJiJaka/beKataka/beKatake/behicaka
beKataka	nisafkoca/niHsafkoca/nissafkoca/beXadaka/safkocahInawaH/beJiJaka/beKataka/beKatake/behicaka
datakara	bahuwa/KUba/KUba/badA/jyAxA/jyAxA/aXika/kAPI/kAPI/kadA/jamakara/datakara
agara	yaxi/agara/jaba
waWApi	Pira_BI/waWApi/waba_BI
IsA_paScAw	IsA_paScAw/I_pa/edI/IsA_paScAw/IsA_paScAw/I_pa/edI/IsA_paScAw
wanika	jarA/jarA/jarA-sA/jarA-sA/rawwiBara/WodA/WodA-sA/WodA_sA/wanika/yawkiMciw
karIba	pAsa_meM/najaxIka/najaxIka/nikata_meM/karIba_meM/samIpa/nikata/pAsa/karIba/karIba/sannikata/najIka/muwwasila/arvAka/avixUra/Are/AsapAsa/Asa-pAsa/anxAjana/anxAjana/anxAjana/anxAjana/lagaBaga/wakarIbana/wakarIbana/karIba/karIba/karIbakarIba/karIbana/karIbakarIba/karIbana/anumAnawaH/anakarIba/anakarIba/waKamInana/anxAja_se/ukavAz
agala-bagala	Asa-pAsa/AsapAsa/agala-bagala/agala-bagala/AjU-bAjU/irxa-girxa/adosa-padosa/pAsa-padosa/pAsa_padosa
