#space dictionary extracted by Monika Sharma. Formatted by Roja (26-01-2016)	#space dictionary extracted by Monika Sharma. Formatted by Roja (26-01-2016)
#Changes:: 1) Separated single word and multi words into separate dictionaries	#Changes:: 1) Separated single word and multi words into separate dictionaries
#          2) English words are converted to lower case	#          2) English words are converted to lower case
#          3) Added category as 'noun' by default	#          3) Added category as 'noun' by default
###############################################################################	###############################################################################
abandon_noun	pariwyAga_karanA
abandoned_noun	pariwyakwa/wyakwa
aberration_noun	vipaWana
ablation_noun	apakRaraNa
ablative_noun	apakRaraka
abort_noun	viPala
abrasion_noun	apaGarRaNa
abrasiveness_noun	apaGarRiwA
absorbency_noun	avaSoRaNAfka/avaSoRakawA
absorber_noun	avaSoRaka
absorptance_noun	avaSoRaNAMSa
absorption_noun	avaSoRaNa
absorptivity_noun	avaSoRakawA
abundance_noun	bAhulya/bahulawA
academic_noun	SEkRika/SEkRaNika
acceleration_noun	wvaraNa
accelerator_noun	wvaraka/wvariwra
accelerograph_noun	wvaraNaleKI/eksilarogrAPa
accelerometer_noun	wvaraNamApI
acceptability_noun	svIkAryawA
access_noun	aBigama
accessibility_noun	aBigamyawA
acclimatization_noun	paryanukUlana/xaSAnukUlana
accommodate_noun	samaFjana_karanA/samAveSa
accommodation_noun	samAveSana/samaFjana
accompanying_noun	saMlagna/sAWa_kA
accomplish_noun	pUrA_karanA
accomplishment_noun	upalabXi
accretion_noun	aBivqxXi
accumulation_noun	saFcaya/saFcayana
accumulator_noun	saFcAyaka/saFcAyaka_sela
accuracy_noun	pariSuxXawA/yaWArWawA
acetylene_noun	EsItilIna
acicular_noun	sUcyAkAra
acoustic_noun	XvAnika/Xvanika
acoustics_noun	XvAnikI/Xvani-vijFAna
acquire_noun	arjana_karanA/upArjana_karanA/aXigrahaNa_karanA
acquired_noun	upArjiwa/arjiwa/aXigrahIwa
acquisition_noun	arjana/aBigrahaNa/aXigrahaNa
acrylate_noun	ekrIleta
acrylonitrile_noun	ekrilonAitrAila
action_noun	kriyA
activation_noun	sakriyaNa
activator_noun	sakriyaka/sakriya_kAraka
activity_noun	sakriyawA
actuator_noun	pravarwaka
acutance_noun	nyUnawva
acyclic_noun	acakrIya
adaptability_noun	anukUlawA
adaptation_noun	anukUlana
adapter_noun	edEptara/anukUlaka
added_noun	saMvarXiwa
adder_noun	yojaka/safkalaka
addition_noun	yoga/joda
additive_noun	yojanI/yojya
address_noun	pawA
addressograph_noun	pawA-leKI/EdresogrAPa
adhesion_noun	AsaFjana
adhesive_noun	AsaFjaka
adiabat_noun	EdiyAbeta
adiabatic_noun	ruxXoRma/EdiyAbetika
adiabaticity_noun	ruxXoRmiwA
adjacent_noun	Asanna/saMlagna
adjunction_noun	sahabanXana
admixture_noun	aXimiSraka
adsorption_noun	aXiSoRaNa
advection_noun	aBivahana
advisory_noun	salAhakAra
aegis_noun	wawvAvaXAna
aeolian_noun	vAwoDa/vAyUDa/vAyugAmI/vAyuvAhiwa
aerial_noun	eriyala/vAyava/AkASI
aero_noun	vAyu
aerodynamic_noun	vAyugawika/vAyugawikIya
aerodynamics_noun	vAyugawikI
aeroelasticity_noun	vAyuprawyAsWawA
aeroelastics_noun	vAyuprawyAsWikI
aerofoil_noun	vAyupawraka
aerograph_noun	vAyuleKI
aeronautical_noun	vEmAnika_iMjIniyarI
aeronomy_noun	vAyavikI
aeropause_noun	vAyu_sImAnwa
aerophone_noun	EroPona
aerophysics_noun	vAyuBOwikI
aeroplane_noun	vimAna/havAI_jahAja
aeroplex_noun	Eropleksa
aerosol_noun	ErosoYEYEYEYla
aerospace_noun	vAnwarikRa/vAyu_AkASa
aerosphere_noun	vAwamaNdala
aerostat_noun	vAyusWApI/avayAna
aerostatics_noun	vAyusWEwikI
aerothermodynamics_noun	vAyuRmAgawikI
aerothermoelasticity_noun	vAyuRmAprawyAsWawA
affect_noun	praBAviwa_karanA
after-effect_noun	paSca_praBAva
afterflow_noun	paSca_pravAha
agamy_noun	ayugmanI
agglomeration_noun	samUhana/sampiMdana
aggradation_noun	aXivqxXi/waloccana
aging_noun	kAla_praBAvana/jaraNa
agitation_noun	prakRoBana
agravic_noun	guruwvahIna
aharonov-bohm-_noun	ehAronova-boma
aileron_noun	sahapakRa
air_noun	vAyu/havA/vAwa
airborne_noun	vAyuvarwI/havAI
aircraft_noun	vAyuyAna
airdose_noun	vAyumAwrA
airglow_noun	vAyuxIpwi
alacrity_noun	wawparawA
albedo_noun	elbido
albedometer_noun	elbidomApI
alcohol_noun	alkohoYla
alert_noun	cewAvanI
algebra_noun	bIjagaNiwa/ElajebrA/bIjAvalI
algebraic_noun	bIjIya
algol_noun	elgoYla/kalana_viXi
algorithm_noun	kalana_viXi/elgoriWma
alias_noun	upanAma
alignment_noun	saMreKaNa
allied_noun	sambanXiwa
allocation_noun	niyawana
allocator_noun	niyawakArI
allotropic_noun	apararUpI
alloy_noun	Eluminiyama_miSraXAwu/miSraXAwu/EloYya/miSrAwu
alloying_noun	XAwu_miSraNa
alternator_noun	prawyAvarwiwra
altimeter_noun	wufgawAmApI
altimetry_noun	wufgawAmiwi
altitude_noun	wufgawA
alumina_noun	EluminA
aluminium_noun	Eluminiyama
aluminizing_noun	EluminIkaraNa
ambient_noun	pariveSa
ambiguity_noun	aspaRtawA/sanxigXawA
amine_noun	EmIna
ammeter_noun	EmItara
amorphous_noun	ravAhIna/akristalIya
ampere-hour_noun	EMpiyara_GaNtA
ampere-turn_noun	EMpiyara_PerA
ampere_noun	EMpiyara
amphoteric_noun	uBayaXarmI
amplidyne_noun	EMplidAina
amplification_noun	pravarXana
amplifier_noun	pravarXaka
amplitude_noun	AyAma
analog_noun	anurUpa/enAloga
analogous_noun	wulyarUpa/samawulya
analysed_noun	viSleRiwa
analyser_noun	viSleRaka
analysis_noun	viSleRaNa
analyte_noun	viSleRya
analytical_noun	viSleRaNAwmaka/vESleRika
analyzing_noun	viSleRaNa/viSleRIkaraNa
anelasticity_noun	viRama_prawyAsWawA
anemometer_noun	pavana_vegamApI
aneroid_noun	nirxrava
angle_noun	koNa
angular_noun	koNIya
anhydride_noun	EnahAidrAida
aniline_noun	EnilIna
anisotropic_noun	viRamaxESika
anisotropy_noun	viRamaxESikawA
annealing_noun	anIlIkaraNa/wApAnuSIwana/anIlana
annihilation_noun	vilopana
annotation_noun	tippaNa
annular_noun	valayAkAra/CallexAra/CallenumA
anode_noun	Enoda
anomalous_noun	asafgawa
anomaly_noun	asafgawi
anorogenic_noun	apavarwanI
anoxia_noun	anoYksiwA
anoxicity_noun	anAksiwawA
antarctic_noun	EntArkataka/xakRiNa_XruvIya
antenna_noun	EntenA
anthropogenic_noun	mAnavoxBavI/mAnavajanya
anti-coincidence_noun	|AwisampAwa
antibunched_noun	prawigucCiwa
antibunching_noun	prawigucCana
anticus_noun	agrABimuKa
antielastic_noun	prawyAsWawAroXI
antiferromagnetics_noun	prawilohacumbakIya_paxArWa
antihalation_noun	prawyAmApana
antilogarithm_noun	EntIlAgariWma/prawilaGugaNaka
antimatter_noun	Entixravya/prawixravya
antimicrophonic_noun	prawimAikroPonika
antimissile_noun	misAilaroXI
antinode_noun	praspanxa
antiparallax_noun	pErelEksahArI
antipleion_noun	nyUnawA_kRewra
antiresonance_noun	prawianunAxa
aperture_noun	xvAraka
apical_noun	SIrRasWa
apogee_noun	apaBU
apogeotropic_noun	BU-apavarwI
apollo_noun	apolo
apparatus_noun	upakaraNa
apparent_noun	ABAsI
apparition_noun	AvirBAva
appearance_noun	prakatana/uxBAsa
appendage_noun	anubanXa
applicability_noun	prayojyawA/prayojanIyawA/upayogaparawA
application_noun	anuprayoga/anuprayojyawA
applied_noun	anuprayukwa
appreciable_noun	suprekRya
appression_noun	ArAnuBUwi
approach_noun	upagamana
appropriate_noun	upayukwa/samuciwa
approximate_noun	sannikata
approximately_noun	sannikatawa:
approximation_noun	sannikatana
arbitrary_noun	svecCa/yAxqcCika
archieval_noun	purAleKI/aBisafgrahI
archieving_noun	aBisafgraha
architectural_noun	vAswukalAwmaka
area_noun	kRewra/kRewraPala
areography_noun	kRewra_vijFAna
argon_noun	Argana
argument_noun	warka/koNAfka
aries_noun	meRa/erIja
armature_noun	Armecara
arming_noun	sajjIkaraNa
aromatic_noun	Erometika
array_noun	vyUha/saraNI
artesian_noun	uwsruwa
artificial_noun	kqwrima
aseismic_noun	aBUkampI
aspect_noun	aBimuKawA
assemblage_noun	kodAnwaraNa/samuccaya
assembled_noun	sajjiwa/kodAnwariwa
assembler_noun	kodAnwaraka
assembly_noun	kodAnwaraNa
assessment_noun	nirXAraNa
assigned_noun	nirxiRta
assimilating_noun	svAfgI
associate_noun	sambaxXa
associated_noun	sambaxXa/sahacArI/safguNiwa
asterik_noun	wArAfka
asteroid_noun	grahikA/kRuxragraha
asteroidal_noun	grahikIya/kRuxragrahIya
asthenosphere_noun	xurbalawA_maNdala
astrocompass_noun	Kagola_kampAsa
astrodome_noun	Kagola_gumbaxa
astrogation_noun	anwarikRa_nOcAlana
astrogeology_noun	Kagola_BUvijFAna
astrographic_noun	wArAciwrI
astrolabe_noun	Estroleba/unnawAMSamApI
astrometry_noun	Kagolamiwi
astronaut_noun	anwarikRayAwrI
astronautics_noun	anwarikRayAnikI
astronomy_noun	Kagola_vijFAna/KagolikI
astropart_noun	Kagola_BAga
astrophysical_noun	Kagola_BOwikIya
astrophysics_noun	Kagola_BOwikI/wArA_BOwikI
asymmetric_noun	asamamiwa
asymmetricity_noun	asamamiwawA
asymmetry_noun	asamamiwi
asymptote_noun	ananwasparSI
asymptotic_noun	upagAmI
asynchronous_noun	awulyakAlika
atlas_noun	mAnaciwrAvalI/etalasa
atmosphere_noun	vAyumaNdala
atmospherics_noun	vAyu-vExyuwa_kRoBa/vAyumaNdalIya_vijFAna
atom_noun	paramANu
atomisation_noun	kaNIkaraNa/kaNana
atomiser_noun	kaNiwra
attenuation_noun	kRINana
attenuator_noun	kRINakArI
attitude_noun	aBivqwwi
attraction_noun	AkarRaNa
attributable_noun	guNAropya
audibility_noun	SravyawA
audible_noun	Sravya
audio_noun	SravaNa
audiogram_noun	SravyawA_AleKa
audiology_noun	SravaNa_vijFAna
audiometry_noun	SravyawAmiwi
augmenting_noun	saMvarXana
authorisation_noun	prAXikIkaraNa
autocatalysis_noun	svowpreraNa
autocatalyst_noun	svowpreraka
autoclave_noun	oYtokleva
autocoder_noun	oYtokodara/svawa:_kodiwra
autocorrelation_noun	svasahasambanXa
autogyro_noun	AtojAyaro
automate_noun	svawa:cAliwa
automation_noun	svacAlana/svacAliwa_yanwra
autopositive_noun	svawa:_XanAwmaka
autorotation_noun	svawa:_GUrNana
auxiliary_noun	sahAyaka/gONa/awirikwa
availability_noun	upalabXawA/prApyawA
avalanche_noun	sKalana/EvalAMSa/avaXAva
avionics_noun	uddayanakI
axial_noun	akRIya
axion_noun	EksiyAna
axis_noun	akRa
axisymmetric_noun	akRawa:_samamiwa
axisymmetry_noun	akRIya_samamiwi
azeotrope_noun	sWirakvAWI/ejotropa
azimuth_noun	xigaMSa
azimuthal_noun	xigaMSIya
azocompound_noun	EjoyOgika
b-display_noun	bIpraxarSa
backing_noun	xqDaaswaraNa
backout_noun	prawivarwana
baffle_noun	bAXikA/vyAroXa
bagasse_noun	KoI
baking_noun	pakAnA
balancer_noun	sanwuliwra
ballast_noun	sWiraka/BAra
ballistic_noun	prakRepika/prAkRepikIya
ballistics_noun	prAkRepikI
balloonborne_noun	bElUnavAhiwa
ballooning_noun	gubbArA_cAlana/bElUnI
balun_noun	bElana
band_noun	pattI/bEMda
banding_noun	pattaracanA/pattana
bandwidth_noun	bEMda_viswAra
bar_noun	xaNda/XArI
barometric_noun	vAyuxAbamApI
baroswitch_noun	bErosvica
barrel_noun	pIpA/bErala
barren_noun	Usara
barretter_noun	bEretara
barricade_noun	surakRA_Biwwi
barrier_noun	avaroXa
baryogenesis_noun	bEriyojanya
baryon-antibaryon_noun	bEriyona/prawi-_bEriyona
baryonic_noun	bEriyonika
barytes_noun	bErAitIja
basaltic_noun	basAltI
base_noun	kRAra/besa/AXAra
basicity_noun	kRArakawA/besisitI
basin_noun	xroNI
batchwise_noun	pracayawa:
battery_noun	bEtarI
beacon_noun	bIkana
bead_noun	maNikA
beading_noun	maNikAyana
beam_noun	kiraNapuFja_bIma
beamwidth_noun	kiraNapuFja_viswAra
bearing_noun	xigmAna/xikkoNa/beyariMga
beat_noun	vispanxa
behaviour_noun	AcaraNa/vyavahAra
bel_noun	bela
bellows_noun	XOMkanI
bend_noun	bafka/moda
bending_noun	bafkana
benzene_noun	benjIna
benzol_noun	benjoYla
berilliosis_noun	beriliosisa
beryllium_noun	beriliyama
betatron_noun	bItAtroYna
bias_noun	aBinawi/bAyasa
biaxial_noun	xvi-akRIya
biconical_noun	xviSafku
bifocal_noun	xviPokasI
bifurcation_noun	xviSAKana
biharmonic_noun	xviprasaMvAxI/bAihArmonika
bimodal_noun	xvibahulaka
bin_noun	bina
binary_noun	xviAXArI
binaural_noun	xvipaWI/xviSravI
binder_noun	yojaka/banXaka
binomial_noun	xvipaxa
binor_noun	bAyanora
bioelectronics_noun	jEva_ilektrAnikI
bionics_noun	bAyonikI/jEva_ilektrAnikI/jEvanikI
biosphere_noun	jEva_maNdala
bipartite_noun	xviviBAjiwa
bipolar_noun	xviXruvI
bird_noun	barda
bis_noun	xviwa
bisector_noun	arXaka
bistable_noun	xvisWiwika
bit_noun	bita/xvayafka
blade_noun	Palaka/bleda
blank_noun	rikwa/blEMka
blanking_noun	lopana
blast_noun	visPota/prasPota
blazar_noun	blAjAra
bleaching_noun	viraFjana
blender_noun	sammiSraka/uwmiSraka
blending_noun	uwmiSraNa/uwmiSraka/sammiSraNa
blooming_noun	vilepana
blow_noun	Xamana/blo/AGAwa
blower_noun	XOMkanI/bloara
blurring_noun	aspaRtawA
boiler_noun	bAyalara/kvaWiwra
bolometer_noun	wejamApI/bolomItara
bolt_noun	kAbalA/bolta
bombardment_noun	bamabArI/bOCAra
bond_noun	banXa/banXana/upabanXa
bonderization_noun	bANdarIkaraNa
bonding_noun	AbanXana/banXana
boom_noun	bUma/xaNdikA
booster_noun	aBivarXaka/bUstara
boosting_noun	aBivarXana
bootstrapping_noun	bUtastrEpiMga
boroscope_noun	boroskopa
bottom_noun	wala/walA
bounce_noun	Jampa/uCAla
bound_noun	sImA/paribanXa
boundary_noun	parisImA/sImAnwa
bpsk-modulation_noun	bI.pI.esa.ke.-_mAdulana
bracket_noun	koRTaka/brEketa
braid_noun	gumPana/gunWana
branching_noun	SAKana
brazing_noun	tAzkA_lagAnA/brejana
break-even_noun	samavicCexa/lABAlABa_sama
breathing_noun	Svasana
breezeway_noun	JaroKA
bright_noun	xIpwa/xyuwimAna/camakIlA
brightening_noun	praBAsana/praxyowana
brightness_noun	xyuwi/praBA/praxIpwi
brilliance_noun	camaka
brine_noun	lavaNa_jala/KArA_pAnI
briquetting_noun	briketIkaraNa
broadcast_noun	prasAraNa
broadening_noun	viswqwIkaraNa
bromine_noun	bromIna
bronze_noun	kAMsA/kAMsya
bubble_noun	bulabulA/buxbux
buckling_noun	AkuFcana
buffer_noun	uBayaprawiroXI/baPara
buffetting_noun	Wapedana
bug_noun	baga/xoRa
bulge_noun	uBAra
bump_noun	kakuxa/uBAra
bumper_noun	bampara
bunching_noun	gucCana
burner_noun	jvAlaka/barnara
burning_noun	jvalana
burst_noun	prasPota
bus_noun	basa
bushing_noun	vyAswara/AswIna/AswIna_lagAnA/buSiMga
butadiene_noun	byUtAdAina
butanol_noun	byUtanola
butene_noun	byUtIna
buzzing_noun	kalasvara
bypass_noun	bAIpAsa
byte_noun	bAita/atTA
c-band_noun	sIbEMda/bEMda_k_-
cable_noun	kebila/samuxrI_wAra/anwararARtrIya_wAra
cabling_noun	wAra_safgraWana/kebaliMga
caging_noun	kejana/paFjarana
caking_noun	kekana
calciner_noun	niswApiwra/niswApaka
calculate_noun	parikalana/gaNanA_karanA
calculator_noun	parikalaka/kElkyuletara
calibrate_noun	aMSAfkana
calibration_noun	aMSAfkana
call_noun	koYla
calorie_noun	kElorI
cam_noun	kEma
camera_noun	kEmarA
camouflage_noun	CaxmAvaraNa
campaign_noun	aBiyAna
can_noun	kena/dibbA
cancelled_noun	niraswa
candela_noun	kendelA
canonical_noun	vihiwa/kEnAnikala
cant_noun	wiraCA
cantilever_noun	Bujowwolaka/kEMtIlIvara/prASa
cap_noun	AcCaxa/topa
capabilitiy_noun	kRamawA
capacitance_noun	XAriwA
capillary_noun	keSikA/kEpilarI
capsule_noun	gutikA/samputa/kEpsyUla
captive_noun	vaSIBUwa/hiwArWa/baxXa
capture_noun	pragrahaNa
carbon_noun	kArbana
carbonaceous_noun	kArbanamaya/kArbanayukwa
carbonate_noun	kArboneta/kArbonetI
carcinotron_noun	kArsinotrAna
card_noun	kArda/pawraka
carina_noun	nOwala/kUtaka
carrier_noun	vAhaka
carry_noun	hAsila/haswafgawa
carrying_noun	vahana_karanA
cartography_noun	mAnaciwrakalA_kArtoseta
cascade_noun	sopAnI
cascading_noun	sopAnana
casing_noun	AvaraNa/Avaraka/kesana
cassette_noun	kEseta
cast_noun	saFcaka/DalA_huA
castability_noun	saFcakanIyawA/DalanIyawA
casting_noun	saFcakana/DalAI/DAlanA/xUraxarSana_prasAraNa
castings_noun	saFcakana_uwpAxana/saFcakana
casualty_noun	kejueltI/awyAhawa
catalysis_noun	uwpreraNa
catalyst_noun	uwpreraka
catenary_noun	kEtinarI/kEtenarI
cathode_noun	kEWoda
causative_noun	kAraka/kAraNI
causticity_noun	xAhakawA/kAstikawA
cavitation_noun	kotarana
cavity_noun	kotara/guhikA/guhA
ceiling_noun	CAxana/CAjana
cell_noun	koRTikA/sela
cellular_noun	sElulara/koRTaka
celluloid_noun	sElulAida
cellulose_noun	sEluloja
cementite_noun	sImeMtAita
centrifugal_noun	apakeMxrI
centrifugation_noun	apakeMxrIkaraNa
centrifuge_noun	apakeMxriwra
centripetal_noun	aBikeMxrI
centroid_noun	keMxraka
ceramics_noun	mqwwikASilpa/siremikI
certificate_noun	pramANa-pawra/sartiPiketa
chain_noun	SqfKalA/cena
challenging_noun	cunOwIpUrNa
chamber_noun	koRTa/kakRa
channel_noun	cEnala/vAhikA
chaos-assisted_noun	aswavyaswawA-_sahAyiwa/avyavasWA-sahAyiwa
chaos_noun	keoYsa/avyavasWA/aswavyaswawA
chaotic_noun	aswavyaswa/avyavasWiwa/keoYtika
char_noun	JulasanA/JulasAnA
character_noun	lakRaNa_guNa/samprawIka
characteristic_noun	aBilakRaNa/lakRaNa/viSeRawA/aBilakRaNika_kakRa/aBilakRaNika_recana
characterization_noun	aBilakRaNana
characterize_noun	aBilakRaNa_varNana
characterized_noun	aBilakRaNa_varNiwa
charactron_noun	kErektrAna
charge_noun	AveSa/cArja/BaraNa
charging_noun	AveSana
charring_noun	Julasana/afgAraNa
chart_noun	cArta/saciwra
chase_noun	cesa
check_noun	parIkRaNa/padawAla/jAzca
chemical_noun	rAsAyanika
chemisorption_noun	rasoSoRaNa
chemistry_noun	rasAyana/SAswra/vijFAna
chevron_noun	paxaPIwI
chimney_noun	cimanI
chip_noun	cipa/CIlana
chipping_noun	CIlanA
chirality_noun	iMgiwA/kAyarelitI
chlorine_noun	klorIna
chlorophyll_noun	kloroPila
choke_noun	coka/avaruxXana
choking_noun	avaroXana
chondrite_noun	koYndrAita
chondrule_noun	koYndala
chopper_noun	Cinnaka/coYpara
chord_noun	jIvA/svara
chromatic_noun	varNika
chromatograph_noun	varNaleKa/krometogrAPa
chromatography_noun	varNaleKikI/krometogrAPI/varNaleKana_vijFAna/viBAjana_varNaleKikI
chromatron_noun	krometroYna
chromosphere_noun	kromosPLyara/varNa-maNdala
chromospheric_noun	varNamaNdalIya
chronological_noun	kAlakramika
chronology_noun	kAlakramikI/kAlAnukramikI
chronotron_noun	kronotroYna
chuffing_noun	apaxahana/aniyamiwa_xahana
chute_noun	pravaNikA
circuit_noun	paripaWa
circuital_noun	parikramI
circulant_noun	cakraka
circular_noun	vqwwIya/vqwwAkAra/varwula
circulation_noun	parisaFcaraNa
circumcentre_noun	parikeMxra
circumferential_noun	pariXIya
circumstellar_noun	wArAparimaNdalIya/pariwArakIya
cirrostratus_noun	sirostretasa_(meGa)
citation_noun	uxXaraNa
cladding_noun	aXipattana/CAxana
clamp_noun	klEMpa/SikaFjA
clarifier_noun	nirmalaka
classical_noun	cirasammawa/ciraprawiRTiwa/klAsikI
classification_noun	vargIkaraNa
classified_noun	vargIkqwa
classifier_noun	vargIkAraka/vargIkAriwra/vargIkara
clay_noun	mqwwikA
clearance_noun	kliyareMsa/niRkAsana
climate_noun	jalavAyu
climatic_noun	jalavAyavI/jalavAyu_sambanXI
climatology_noun	jalavAyu_vijFAna
clipper_noun	karwaka
clipping_noun	karwana
clocking_noun	kAlabanXana
clog_noun	upAroXa/avaroXa
clogging_noun	avaroXana/uparoXana
clone_noun	pUrvajaka
close_noun	saMvqwa/banxa
clot_noun	WakkA
cluster_noun	puFja/klastara/gucCa
clutch_noun	safgrAha/klaca
cluttering_noun	kalaravana/klatarana
co-dominant_noun	sahapraBAvI_guNAfka
co-operation_noun	sahakArI/sahayoga
co-volume_noun	saha-Ayawana
coagulation_noun	Wakke_bananA
coagulum_noun	skanxa
coarseness_noun	sWUlawA
coastal_noun	watIya
coat_noun	lepa
coating_noun	lepa/vilepana
code_noun	koda
coding_noun	kodana/kodiMga
coefficient_noun	guNAfka
coercivity_noun	nigrAhiwA
cofactor_noun	sahakAraka
coherence_noun	sambaxXawA/saMsakwawA
coherent_noun	sambaxXa/saMsakwa
coherently_noun	sambaxXawayA
cohesive_noun	saMsaFjaka
coil_noun	kuNdalI
coincidence_noun	sampAwa/saMyoga
coke_noun	koka
coking_noun	kokiMga
cold_noun	SIwa/awapwa
collaboration_noun	sahaBAgiwA
collapse_noun	nipAwa
collapsible_noun	safkocya
collator_noun	samAnukramiwra
collective_noun	sAmUhika
collector_noun	safgrAhaka/safgrAhI
collider_noun	safGattaka
colligate_noun	sahayojI
collimator_noun	koYlimetara/samAnwarakArI/samAnwariwra
collision_noun	safGatta/takkara/safGattana
colloquium_noun	samBARaNa
colonial_noun	nivAhI/OpaniveSika
column_noun	swamBa/kAlama
columnar_noun	swamBI
combuster_noun	prajvalaka
combustion_noun	xahana/prajvalana
combustor_noun	xahana_wanwra
comet_noun	XUmakewu/pucCala_wArA
cometary_noun	XUmakewava
command_noun	kamANda/AxeSa
commemorate_noun	yAxagAra
commission_noun	xalAlI/kamISana/Ayoga
commissioned_noun	aXikqwa/cAlU_kiyA
common_noun	sAmAnya
commutation_noun	xikparivarwana
commutator_noun	xikparivarwaka
compact_noun	saMhawi/susaMhawi/saMhawa/susaMhawa/saMhawa_karanA/saMhawa_honA
compacting_noun	saMhanana
compandor_noun	kampendara
companion_noun	sAWI/sahacara
comparator_noun	wulaniwra/kamperetara/wulanAkArI
compare_noun	wulanA_karanA
comparison_noun	wulanA
compartment_noun	kakRa
compatibility_noun	safgawawA
compatible_noun	safgawa/anukUla
compensating_noun	prawikArI
compensation_noun	prawipUrwi/prawipUraNa/kRawipUrwi
compensator_noun	kRawipUraka/prawipUraka
competency_noun	sakRamawA
compilation_noun	safkalana
complement_noun	pUraka/koYmplImeMta
completeness_noun	pUrNawA
complexity_noun	jatilawA
component_noun	Gataka
composition_noun	saMyojana/safGatana/saMracanA
comprehensive_noun	vyApaka
compress_noun	saNdIpana
compressibility_noun	sampIdyawA/coefficient_sampIdyawA_guNAfka
compression_noun	sampIdana
comprise_noun	samAviRta_karanA
computation_noun	aBikalana
computational_noun	aBikalanI/parikalanAwmaka
computationally_noun	aBikalanIyawa:
computer_noun	kampyUtara
computerization_noun	kampyUtarIkaraNa
comsat_noun	kAmasEta/saFcAra_upagraha
concatenation_noun	saMSqfKalana
concentrate_noun	sAnxra_safkeMxriwa_BAra
concentric_noun	safkeMxrI
conception_noun	safkalpanA
conceptual_noun	safkalpanAwmaka
concerted_noun	samanviwa
conclusion_noun	pariNAma/niRkarRa
concordance_noun	sAmaFjasya
concordant_noun	susafgawa/susvara/anuswarI
concourse_noun	jamAva
condensant_noun	xravaNI
condensate_noun	xrAva/safGaniwa
condenser_noun	safGaniwra
condition_noun	prawibanXa/avasWA/parisWiwi/sWiwi/samaprawibala_prawibanXa
conditioning_noun	prAnukUlana
conductance_noun	cAlakawva
conduction_noun	cAlana
conductivity_noun	cAlakawA
cone_noun	Safku
configuration_noun	vinyAsa/saMrUpaNa
configure_noun	saMrUpaNa
congeneric_noun	sahowpanna
coning_noun	Safkvana/koniMga/SafKana
conjugate_noun	saMyugmI
conjunction_noun	safgamana/saMyogI/yuwi
connection_noun	sambanXana/(sI.sI.)_sambanXana/sambanXa/saMyojana
connectivity_noun	saMyojakawA/sambanXawA
connector_noun	yojI/kanektara/sambanXaka/anuyojaka
consequently_noun	wawpaScAw
conservative_noun	saMrakRI/rUDa
consider_noun	vicAra_karanA
consist_noun	samAviRta_karanA
console_noun	kansola
conspicuously_noun	spaRtarUpeNa
constancy_noun	sWirawA/niyamiwawA
constant_noun	sWirAfka/niyawAfka
constellation_noun	wArA-maNdala/wArA_samUha
constituent_noun	avayava/racaka/safGataka
constraint_noun	vyavaroXa
consultation_noun	parAmarSa
consumption_noun	vyaya/upaBoga/Kapawa
contact_noun	samparka/sparSa
contactor_noun	samparkiwra
contain_noun	anwarviRta_karanA
contamination_noun	sanxURaNa
contemporary_noun	samakAlIna
content_noun	anukramaNikA/viRaya-vaswu
context_noun	prasafga/sanxarBa
continental_noun	mahAxvIpI/mahAxeSI
continuation_noun	sAwawya/jArI_raKanA
continue_noun	viwawa/sawawa
continuous_noun	jArI/sanwawa/aKaNda/aviCinna/avirawa/sawawa
contour_noun	kaNtUra/parireKA/samocca
contra-injection_noun	prawi-anwa:kRepaNa
contrast_noun	viparyAsa/vyawireka/kantrAsta
contravention_noun	KaNdana/ullafGana
contribution_noun	yogaxAna
control_noun	niyanwraNa
convection_noun	saMvahana
conventional_noun	rUDa/pAramparika/paramparAgawa
convergent_noun	aBisArI
conversion_noun	rUpAnwaraNa/parivarwana
converter_noun	parivarwaka
conveyor_noun	saMvAhaka
convolution_noun	saMvalana
coolant_noun	SIwalaka
cooler_noun	SIwaliwra/SIwala_yanwra/kUlara
cooling_noun	SIwalana
coordinate_noun	nirxeSAfka/samanviwa_karanA
copolymerization_noun	saha-bahulakIkaraNa
coprecipitation_noun	sahaavakRepaNa
cordite_noun	kordAita
core_noun	kora/kroda
corona_noun	praBAmaNdala/koronA/kirIta
coronal_noun	praBAmaNdalIya
coronograph_noun	praBAmaNdalaleKI/koronogrAPa
correction_noun	saMSuxXi/saMSoXana
correlate_noun	paraspara_sambanXa_karanA
correlated_noun	sahasambanXiwa
correlation_noun	sahasambanXana/sahasambanXa
correspondence_noun	safgawi/pawrAcAra
corresponding_noun	safgawa
corrosion_noun	safkRAraNa
corrosive_noun	safkRAraka/safkRArI
corrosivity_noun	safkRArakawA
corrugation_noun	nAlIxAra
cosmic_noun	kAsmika/brahmANdIya/anwarikRa
cosmogenic_noun	brahmANdajaniwa/koYsmika_kiraNajaniwa
cosmology_noun	brahmANda_vijFAna/brahmANdikI
coulometer_noun	kUlomApI/kUlomItara
coulometry_noun	kUloYmiwi
counter_noun	kAuNtara/gaNaka/patala
counteract_noun	prawikAra
counterbalance_noun	prawi-sanwulana
countermeasure_noun	prawyupAya
counterpart_noun	sampUraka
coupled_noun	yugmiwa
coupling_noun	yugmana
courier_noun	kUriyara
covariant_noun	sahaparivarwI
covariation_noun	sahavicaraNa
cover_noun	AcCAxana/Avqwwa
coverage_noun	prasAraNa_kRewra
crack_noun	xarAra
crater_noun	kretara
crestal_noun	SIrRa
cretaceous_noun	kriteSiyasa
criterion_noun	mAnaxaNda/kasOtI/nikaRa
critical_noun	krAnwika/samIkRAwmaka
cropland_noun	KewIBUmi/SasyaBUmi
cropping_noun	Pasala_ugAnA
cross-correlation_noun	vyawi_sahasambanXa
crucial_noun	nirNAyaka/kaTina
crush_noun	sanxalana/pIsanA
cryogen_noun	nimna_wApa/krAyojana
cryogenic_noun	nimnawApIya
cryogenics_noun	nimnawApikI/krAyojenikI
cryology_noun	nimna_wApa_vijFAna
cryostat_noun	nimnawApasWApI
cryotron_noun	krAyotroYna
cryotronics_noun	nimnawApa_ilektrAnikI/krAyotronikI
cryptography_noun	gUDaleKana/gUDa_leKikI
crystal_noun	kristala/ravA
crystallinity_noun	kristalawA
crystallization_noun	kristalIkaraNa
crystallographic_noun	kristalIya_xiSA
crystallography_noun	kristalikI/kristala_vijFAna
cubical_noun	Gana/GanIya
cumulative_noun	saFcayI
curative_noun	kyUretiva/prapiMdI
curator_noun	kyUretara/prapiMdaka
curing_noun	wEyAra_karanA/praTosana
current_noun	XArA
curvature_noun	vakrawA
cut-off_noun	anwaka/kata-oYPa
cutting_noun	kawarana/karwana/katAI
cuttle_noun	maXyavalana
cyan_noun	PirojI
cybernatics_noun	sAibaranetiksa
cycle_noun	cakra/prakriyA
cycling_noun	cakraNa
cyclization_noun	cakrIkaraNa
cycloid_noun	cakraja/cakrABa
cyclone_noun	cakravAwa
cyclotron_noun	sAiklotrAna
cylinder_noun	belana/siliMdara
cylindrical_noun	belanAkAra/siliMdarAkAra/belanI/siliMdarI
cyst_noun	putI
damper_noun	avamanxaka
damping_noun	avamanxana
dampness_noun	sIlana
data_noun	detA/Azkade
database_noun	detAbesa
datum_noun	detama/AXAra
dcpsk-modulation_noun	dI.sI.pI.esa.ke._mAdulana
debunching_noun	vigucCana
decantation_noun	niWAranA/niswAraNa
decarburisation_noun	vikArburIkaraNa
deccan_noun	xakRiNI
decelerometer_noun	manxanamApI
deception_noun	BrAmana
decibel_noun	desibala
decimal_noun	xaSamalava
deck_noun	deka/gaddI
declaration_noun	GoRaNA
declination_noun	xikpAwa
declinometer_noun	xikpAwamApI
decoder_noun	kUtavAcaka/vikodaka
decoding_noun	vikodana
decoherence_noun	asaMsakwi
decolourizer_noun	vivarNaka
decommutation_noun	viparivarwana
decomposer_noun	apaGataka/viyojaka
decomposition_noun	apaGatana/viyojana
decompression_noun	visampIdana
decontamination_noun	visanxURaNa
decoupled_noun	ayugmiwa/viyugmiwa
decrease_noun	hrAsa/GatanA_hrAsa/honA
decremeter_noun	hrAsamApI
dedicated_noun	samarpiwa
deduction_noun	nigamana/GatAva
deemphasis_noun	abalana/viprabalana
deenergize_noun	viUrjAyiwa_karanA/viUrjAyana
deexcitation_noun	vyUhawejana
defect_noun	kamI/wruti/xoRa
defective_noun	saxoRa
defectoscope_noun	xoRaxarSI
deficit_noun	aBAva/kamI
defined_noun	niSciwa/spaRta
definition_noun	pariBARA
deflasher_noun	apasPuraka
deflect_noun	vikRepiwa_karanA
deflection_noun	vikRepaNa/vikRepa
deflector_noun	vikRepaka
deflushing_noun	praXAvana
defoamer_noun	viPenaka
defoliating_noun	niRpawraNa
deforestation_noun	vana_nASana/vana_Cexana
deformation_noun	virUpaNa/vikqwi
deforming_noun	virUpaNa
deformity_noun	virUpawA
defrosting_noun	apahimana/barPa_piGalAnA
degasifier_noun	vigEsaka/vigEsiwra
degeneracy_noun	apaBraRtawA
degenerate_noun	samArja
degradation_noun	nimnIkaraNa
degreasing_noun	visnehana_digrI/aMSa/aMSAfka/GAwa/koti/mAwrA/parimANa
dehydration_noun	nirjalIkaraNa/nirjalana
delamination_noun	viswaraNa/vipatalana
delay_noun	vilamba
delayer_noun	xahana_manxaka/vilambaka
deliberation_noun	vicAra-vimarSa
delimited_noun	parisImiwa
delimiter_noun	parisImaka
delimiting_noun	parisImana
delineation_noun	nirUpaNa/sImAfkana
deliquescent_noun	lInAkRa/prasvexI/pasIjane_vAlA
delta_noun	deltA
deltoid_noun	anwarArIya_patta/wriBujI_patta
demagnetisation_noun	vicumbakana
demagnetiser_noun	vicumbakiwra
demodulation_noun	vimAdulana/vimoYdulana
demodulator_noun	vimAdulaka
demonstrable_noun	praxarSanIya
demonstrate_noun	nirUpaNa_karanA/pramANa_xenA/nixarSana_karanA
demonstration_noun	|AxarSanAwmaka
demoulding_noun	nisaFcakana
demultiplexer_noun	bahuvisafkewaka
dendrite_noun	dendrAita/xrumAkqwi
densener_noun	Ganiwra
densitometer_noun	saGanawAmApI
density_noun	Ganawva/saGanawA/prAyikawA_saGanawA
dent_noun	denta
depend_noun	nirBara_karanA/nirBara_honA
dependence_noun	nirBarawA
dependent_noun	nirBara/ASriwa
depleted_noun	avakRayiwa/rikwiwa
depletion_noun	avakRaya/rikwana
deployable_noun	viswarIya
deployment_noun	viswaraNa
depolymerization_noun	vibahulakIkaraNa
deposition_noun	nikRepaNa
depreciation_noun	avamUlyana
depression_noun	avanamana
depressurisation_noun	vixAbana
depth_noun	gamBIrawA/gaharAI
derating_noun	anumawAfka_nimnana
derivation_noun	vyuwpawwi/vyuwpanna/avakalana
derivative_noun	avakalaja/vyuwpanna
descaling_noun	viSalkana
descrambler_noun	sametaka
descrambling_noun	sametanA
describe_noun	varNana_karanA/KIMcanA/nirmANa_karanA
description_noun	varNana/nirmANa
desensitizer_noun	visugrAhI/visugrAhIkara/visensItAijara
desertification_noun	marusWalIkaraNa/marUkaraNa
desolder_noun	hatAnA
despin_noun	vicakraNa
despinning_noun	vicakraNa
destruction_noun	vinASa
desublimation_noun	aXopiMdana
detail_noun	vivaraNa
detection_noun	saMsUcana/pahacAna/aBijFAna
detectivity_noun	saMsUcanawA
detector_noun	saMsUcaka
detergent_noun	apamArjaka/ditarjeMta
determinant_noun	sAraNika/ditarminenta
determination_noun	nirXAraNa
determine_noun	nirXAriwa_karanA
deterministic_noun	nirXAraNAwmaka
detonation_noun	aXisPotana
development_noun	vikAsa
deviation_noun	vicalana
device_noun	yukwi
dewatering_noun	SuRkana/vijalana
dewetting_noun	viklexana
diactor_noun	sIXA_svawa:_niyAmaka/dAiEktara
diagenesis_noun	prasafGanana
diagonal_noun	vikarNa
diagonalization_noun	vikarNana
diagram_noun	AreKa
dial_noun	dAyala
dialysis_noun	apohana/dAyalisisa
dialyzer_noun	apohaka/dAyalAijara
diamagnetic_noun	prawicumbakIya
diamagnetics_noun	prawicumbakawva_vijFAna
diamagnetism_noun	prawicumbakawva
diameter_noun	vyAsa
diaphragm_noun	wanupata/dAyAPrAma
diapositive_noun	dAyApAjitiva
diathermancy_noun	URmA-pAryawA
diathermic_noun	URmA-pArya
diathermometer_noun	URmA_pAryawAmApI
diathermy_noun	dAyaWarmI
diatomic_noun	xviparamANuka
dichroism_noun	xvivarNawA
dichromatism_noun	xvivarNakawA/xqRti_xvivarNawA/swarIya_xvivarNawA/xviraFjakawA
diclinic_noun	xvinawika
die_noun	dAI/rUpaxA
dielectric_noun	parAvExyuwa/dAiilektrika
dielectrics_noun	parAvExyuwikI
different_noun	anwaraja/Binna
differential_noun	viBexaka/BexaxarSI/avakala/anwarAwmaka/viBexI/avakala_vivikwikara
differentiation_noun	viBexana
differentiator_noun	anwaraka/viBexaka
diffraction_noun	vivarwana
diffractometer_noun	vivarwanamApI
diffuser_noun	visAraka
diffusion_noun	visAra/visaraNa
digit_noun	afka
digital_noun	afkIya/dijitala
digitization_noun	afkIkaraNa
dilatancy_noun	visPAriwA
dilation_noun	visPAra
dilatometer_noun	Ayanana_praBAramApI/visPAramApI
dilatometry_noun	visPAramiwi
dilution_noun	wanuwA
dimension_noun	vimA/GAwa/viswAra
dimensional_noun	vimIya
dimer_noun	xviwaya
dimmer_noun	avaxIpwaka/xIpwimanxaka
dimorph_noun	xviwIya_rUpa
diode_noun	dAyoda
dip_noun	namana/nawi/nimajjana/garwa
diplexer_noun	xvisafkewaka/xviyugmaka
dipole_noun	xviXruva/dAipola
dipping_noun	nimajjana
direction_noun	xiSA
directivity_noun	xESikawA
disappearance_noun	vilopana
discharge_noun	visarjana/AsrAva
discipline_noun	viRaya
discontinuity_noun	Bafga/asAnwawya
discoverer_noun	KojakarwA
discovery_noun	Koja
discrepancy_noun	visafgawi
discrimination_noun	vivikwakaraNa
discriminator_noun	/anwarI_vivikwikara/vivikwakara
discussion_noun	carcA
disk_noun	diska/cakrikA/wavA
dislocation_noun	sWAna-BraMSa/sWiwi_BraMSa/praBraMSa
dismantle_noun	viGatiwa_karanA
disorder_noun	avyavasWA/akrama_vikAra
disorientation_noun	apavinyAsa/sWiwiBrAnwi
dispersed_noun	parikRipwa/prakIrNa/parikRepiwa
dispersibility_noun	parikRepaNawA
dispersion_noun	parikRepaNa/prakIrNana
dispersity_noun	parikRepyawA
dispersivity_noun	parikRepakawA
displaced_noun	visWApiwa
displacement_noun	visWApana
dissemination_noun	vipraWana/prakIrNana/prasAra
dissipation_noun	kRaya
dissociation_noun	viyojana/viBAjana
dissolution_noun	vilayana
dissolved_noun	vilayiwa
distal_noun	xUrasWa
distance_noun	xUrI
distillation_noun	Asavana
distinct_noun	Binna/alaga/suspaRta/suvyakwa
distinctive_noun	viSiRta/vivikwakArI
distinguish_noun	viBexana/Bexa_karanA
distortion_noun	virUpaNa/vikqwi
distortionmeter_noun	virUpaNamApI/vikqwimApI
distress_noun	vipawwi
distribution_noun	prAyikawama_baNtana/viwaraNa/baNtana/kaNa_mApa_baNtana
disturbance_noun	vikRoBa
dither_noun	diWara/WaraWarAnA
divergence_noun	apasaraNa/apasAriwA
divergent_noun	apasArI
divider_noun	viBAjaka
division_noun	BAga/praBAjana/viBAjana/praBAga
dodging_noun	niKArana
domain_noun	prakRewra/praBAvakRewra
domed_noun	gumbaxaxAra/gumbaxAkAra
domestic_noun	GarelU
dominance_noun	praBuwvawa/pramuKawA
dominant_noun	praBAvI/pramuKa
donor_noun	xAwA
doping_noun	mAxana/apamiSraNa/dopana
doppler-effect_noun	doYplara-praBAva
doppler-ratio_noun	doYplara-anupAwa
doublet_noun	xvika/jodI
dough_noun	do
doughnut_noun	donata
dovap_noun	dovepa
down-wind_noun	anuvAwa
download_noun	uwAra_lenA/dAunaloda
drag_noun	karRaNa
drainage_noun	apavAhikA/jala_nikAsI
dramatic_noun	nAtakIya
drawing_noun	AreKaNa/AreKa/drAiMga
drier_noun	SuRkiwra/SuRkaka/drAyara
drift_noun	apavAha/vAha/driPta
drifting_noun	apavAhiwa
drilling_noun	veXa/veXana/Cexa_karanA
drip_noun	dripa/tapaka
drive_noun	cAlana
drop_noun	pawana/bUnxa
dropout_noun	pAwa_(electronics)/nirgama_pAwa_(coMp.)/unmocaka_(rock.)
drought_noun	sUKA/varRAhIna
dual_noun	yugala
duality_noun	xvEwawA/xoharApana
dubbing_noun	Xvani_anwaraNa
ductile_noun	wanya
ductility_noun	wanyawA
ductilometer_noun	wanyawAmApI
dump_noun	sannikRepa/dampa
dumping_noun	sannikRepaNa
duplexer_noun	xvEXaka
dust_noun	XUla/XUli
dwell_noun	vAsa
dyad_noun	xvisaMyuja
dyadic_noun	xvikIya
dye_noun	raFjaka
dynamic_noun	gawika
dynamics_noun	gawikI
dynamometer_noun	dAyanemomItara
dyschronous_noun	BinnakAlIya
earth_noun	BUmi/pqWvI/BU
earthing_noun	BU-samparka
ebb_noun	BAtA
eccentricity_noun	uwkeMxrawA
echo_noun	prawiXvani/gUFja
echobox_noun	prawiXvani_petI
eclipse_noun	grahaNa
eclipsed_noun	grasiwa
ecliptic_noun	krAnwivqwwa/ekliptika
ecology_noun	pArisWiwikI/parisWiwi_vijFAna
eddy_noun	Bazvara/cakravAwa
editorial_noun	sampAxakIya
effective_noun	praBAvI/kAryakArI
efficiency_noun	xakRawA
efficient_noun	xakRa
effluent_noun	bahi:srAva
efflusion_noun	nissaraNa
effort_noun	prayAsa
ehilatus_noun	anABika/nABikAhIna
ejection_noun	niRkAsana/pqWakkana/uwkRepaNa
ejector_noun	pqWakkiwra
elastic_noun	prawyAsWa
elastica_noun	prawyAsWikA
elasticity_noun	prawyAsWawA
elasticometer_noun	prawyAsWawAmApI/ilEstikomItara
elastomer_noun	prawyAsWaka/ilestomara
elastoplastic_noun	prawyAsWa_suGatya/prawyAsWa_plAstika
elbowmeter_noun	elbomItara
electricity_noun	vixyuwa
electroacoustics_noun	vixyuwa-XvAnikI
electrobiology_noun	vixyuwa_jEvikI
electrocardiograph_noun	vExyuwa-hqxleKI
electrochemistry_noun	vixyuwa_rasAyana_SAswra
electrodialysis_noun	vixyuwa_apohana
electrodynamics_noun	vixyuwagawikI/vixyuwacumbakIya_warafga_gawikI
electroforming_noun	vExyuwa_aBirUpaNa
electrohydraulic_noun	vixyuwa_xravacAliwa
electrojet_noun	AyanamaNdalIya/vixyuwa_praXAra/ilektrojeta
electromagnet_noun	vixyuwacumbaka
electromagnetics_noun	vixyuwa_cumbakI/vixyuwa_cumbakIya_vijFAna
electron_noun	ilektroYna
electronic_noun	ilektroYnika
electrostatic_noun	sWira_vExyuwa/sWEwika_vExyuwa
electroweak_noun	vixyuwa_kRINa
element_noun	wawva/mUla_wawva/ElImenta/avayava/alpAMSa
elevated_noun	unnawa/uwWiwa/unnayiwa
elevation_noun	eliveSana/unnayana/uwWAna/unnawAMSa/uxvikRepa
elevator_noun	Elivetara/ucAlaka
ellipse_noun	xIrGavqwwa/elipsa
ellipsoid_noun	xIrGavqwwaja
elliptical_noun	xIrGavqwwIya/aNdAkAra
ellipticity_noun	xIrGavqwwawA
elongation_noun	xErGyavqxXi/xIrGIkaraNa
elusive_noun	xurlaBya
embedded_noun	anwa:sWApiwa/samAhiwa
embrittlement_noun	BafguraNa/BafgurakaraNa
emergence_noun	nirgamana/uxBUwAfga/AvirBAva/uxBava/uxgamana
emergency_noun	ApAwasWiwi/ApAwakAla
emergent_noun	nirgawa/uxgAmI/nirgAmI
emerging_noun	AvirBAvI
emission_noun	uwsarjana
emissivity_noun	uwsarjakawA/uwsarjiwA
emittance_noun	uwsarjanAMSa
emitter_noun	uwsarjaka/emitara
empirical_noun	AnuBavika
emulsifier_noun	pAyasIkAraka/imalsIkAraka
emulsion_noun	pAyasa/imalSana/pAyasa_bahulakIkaraNa
encapsulate_noun	samputiwa
encoder_noun	kodiwra
encoding_noun	kodana
encompass_noun	Avqwa
encounter_noun	samAgama
encryption_noun	gUDaleKana/gupwa_leKana
encumbrance_noun	BAra
encyclopedia_noun	viSvakoSa
end_noun	anwya/anwa/kora/sirA
endeavour_noun	prayAsa
endogamy_noun	anwa:safgama/anwa:saMlayana
endosphere_noun	anwa:maNdala
endothermic_noun	AnwaroRmI/URmASoRI
endowment_noun	akRayaniXi
endurance_noun	sahanaSIlawA/sahyawA
energetic_noun	Urjiwa
energizer_noun	Urjaka
energy_noun	UrjA
engine_noun	iMjana/iMjanar
enhance_noun	baDAnA/varXana
enhancement_noun	saMvqxXi
enrich_noun	samqxXa_karanA
enrichment_noun	samqxXi
ensemble_noun	samuccaya/samuxAya/samaRti/Woka/samUha
entangle_noun	ulaJanA
entanglement_noun	ulaJAva
enthalpy_noun	pUrNa_URmA/EMWElpI
entity_noun	sawva
entrainment_noun	saMrohaNa
entrepreneur_noun	uxyamI
entropy_noun	eMtroYpI
entrust_noun	sOMpanA
envelope_noun	AcCAxa/AcCAxana
environment_noun	paryAvaraNa
envisage_noun	pariciMwana
epadditive_noun	carama_xAba_yogya
ephemeris_noun	paFcAfga
episodically_noun	prAsafgika/yaxA-kaxA
epithet_noun	safkewapaxa
epoch_noun	GatanA/yuga
epoxy_noun	epoYksI
eprom_noun	Iproma
equalization_noun	samakaraNa/wulyakaraNa
equalizer_noun	samakArI/samakAraka
equation_noun	samIkaraNa
equator_noun	BUmaXyareKA/viRuvawa_reKA/ikvetara
equatorial_noun	nirakRIya/viRuvawIya/BU-maXya_reKIya
equilateral_noun	samabAhu
equilibration_noun	sAmyana
equilibria_noun	sAmya
equilibrium_noun	sanwulana/sAmya/sAmyAvasWA/wriAXArI_prAvasWA_sAmya
equinox_noun	viRuva
equipment_noun	upaskara/upakaraNa
equipped_noun	sajjiwa
equivalent_noun	wulya/wulyamAna/wulyAfka
erasable_noun	metanIya
erection_noun	unnirmANa/uTAva
ergodic_noun	aByawiprAya
ergometer_noun	argamApI
ergonomics_noun	kAryAnukUlana_vijFAna
eros_noun	eroYsa
erosion_noun	aparaxana
erratic_noun	aniyamiwa
error_noun	wruti/galawI
eruptive_noun	uxgArI/uxBexI/visPotaka
established_noun	sWApiwa
estimate_noun	Akalana/Akalana_karanA
estimation_noun	Akalana
estimator_noun	Akalaka
etching_noun	nikRAraNa
ether_noun	IWara
ethylene_noun	eWilIna
eutectic_noun	yUtektika
evacuation_noun	nirvAwana/rikwikaraNa
evaluation_noun	mUlyAfkana
evaporation_noun	vARpana/vARpIkaraNa/vARpIBavana
evaporator_noun	vARpiwra
evapotranspiration_noun	vARpana/vARpowsarjana
eventual_noun	anwawa:
evidence_noun	sAkRya/pramANa
evolution_noun	vikAsa/vimocana/nikAsa/mUlakalana
evolutionary_noun	vikAsIya
evolve_noun	vikAsa
evolving_noun	vikasana
example_noun	uxAharaNa
excavation_noun	uwKanana/KuxAI
exchange_noun	vinimaya
excitation_noun	uwwejana/Urjana
excited_noun	uwwejiwa
excitement_noun	uwwejanA
exciter_noun	uwwejaka
excitron_noun	EksAitrAna
executed_noun	niRpAxiwa/anupAliwa
execution_noun	niRpAxana/kriyAnvayana
exert_noun	kriyASIla/lagAnA
exhaust-velocity_noun	vega
exhaust_noun	niRkAsana/nikAsa/recaka/nirvAwa
exhausted_noun	reciwa/samApwa/nirvAwa
exhibit_noun	praxarSa/JAfkI
exigency_noun	awyAvaSyakawA
exist_noun	vixyamAna_honA
existence_noun	vixyamAnawA
exit_noun	nirgama/nikAsa
exosphere_noun	bahirmaNdala
expandability_noun	viswAriwa/prasaraNIyawA
expander_noun	prasAriwra
expanding_noun	prasArI
expansion_noun	prasAra/prasaraNa
expedition_noun	aBiyAna
experience_noun	anuBava
experiment_noun	parIkRaNa/prayoga
experimentally_noun	prAyogika_rUpa_se
explicit_noun	spaRta
explode_noun	visPota
exploit_noun	xohana
exploration_noun	anveRaNa/Koja
explorer_noun	samanveRaka/eksaplorara
explosion_noun	visPotana
explosive_noun	visPotaka/visPotI
exponent_noun	GAwAfka/GAwa
exponential_noun	caraGAwAfkI
exposure_noun	anAvaraNa/praBAvana/uxBAsana/ucCAxana/apAvaraNa_uxBAsana_guNaka
expression_noun	niRpIdana/vyaFjaka/muKAkqwi/BAvAkqwi/aBivyakwi
expulsion_noun	bahiRkaraNa/niRkAsana
extended_noun	viswqwa
extension_noun	viswAra/viswaraNa/viswqwi
extensionmeter_noun	viswAramApI
extensive_noun	viswIrNa/viswqwa/vyApaka
extensively_noun	vyApaka_rUpa_se
external_noun	bAhya
extinction_noun	vilopana/vilopa/niRkarRaNa
extinguisher_noun	SAmaka
extract_noun	nicoda/sAra_nikAlanA/niRkarRaNa_karanA
extraction_noun	niRkarRaNa
extractive_noun	niRkarRaNI
extragalactic_noun	parAgAfgeya/parAgEleksIya
extrapolate_noun	bAhyakalana_karanA/bahirveSana
extrapolation_noun	bAhyakalana/bahirveSana
extraterrestrial_noun	BOmewara/pArWivewara
extremely_noun	niwAnwa
extrusion_noun	bahirveXana/uwsAraNa
exudate_noun	risAva/ni:srAva
exudation_noun	prasvexana/ni:srAva/ni:sravaNa
eyepiece_noun	newrikA
f-layer_noun	F-swara/ePa-parawa
fabric_noun	saMvinyAsa/wAnA_bAnA
fabricated_noun	saMviraciwa
fabrication_noun	saMviracana
fabry-perot_noun	PEbrI_pero
face_noun	muKa_patta/Palaka/pArSva
facility_noun	suviXA
factor_noun	Gataka/upAxAna/kAraka/KaNda/guNanaKaNda/guNaka
fading_noun	GatabaDa
failure_noun	viPalawA
falcon_noun	KagAnwaka
farad_noun	PErada
fastener_noun	kIlaka/banXaka
fatigue_noun	SrAnwi
fdma-intermodulation_noun	ePa.dI.ema.e.-_anwarAmAdulana
feasibility_noun	sAXyawA/SakyawA/samBAvyawA
feather-edge_noun	pafKa_kora
feature_noun	lakRaNa
feeble_noun	kRINa
feed_noun	BaraNa/PIda
feeder_noun	BarikA/PIdara
feeding_noun	niveSana
felting_noun	namaxana
fenland_noun	pafkaBUmi
fermion_noun	ParmioYna
ferromagnetic_noun	lohacubafkIya/lohacumbakIya
ferruginous_noun	lohamaya/maNdUravarNI
ferrule_noun	PerUla
fertilizer_noun	urvaraka
fiber_noun	reSA/PAibara/wanwu
fiberscope_noun	wanwuxarSI/PAibaraskopa
fibril_noun	reSaka/wanwuka
fibring_noun	reSAyana
fidelity_noun	waxrUpawA
field_noun	PIlda/kRewra
figure_noun	afka_(ddawDawxya)/ciwra/Akqwi
filament_noun	sUwra/wanwu/PilAmeMta
file_noun	rewI/misila/PAila/saFcikA/rewanA
filler_noun	BarAva/BarAna/pUraka
fillet_noun	pawalA_tukadA/capawI_pawwI/Pileta
fillip_noun	baDAvA
film_noun	Pilma/parawa
filter_noun	Piltara/CananI
filterability_noun	CananIyawA
filteration_noun	Canana
filtering_noun	Canana/CanAI/CAna-kriyA
fin_noun	pafKadA/pafKadI
fine_noun	pariRkqwa/pawalA/sUkRma/mahIna/bArIka
finish_noun	pariRkqwa/samApwa
fire_noun	agni/xAganA
firing_noun	jvAlana/xAganA
firmly_noun	suxqDawApUrvaka
fittings_noun	sAja-sAmAna
fixer_noun	sWAyIkAraka
fixture_noun	anulagnI_anubanXa
flake_noun	pawraka
flame_noun	jvAlA
flammability_noun	jvalanaSIlawA
flange_noun	PleMja/sPAra
flare_noun	prajvAla/sOra_saMsPura
flash_noun	kRaNaxIpwi/sPura/xamaka
flashing_noun	prajvalana/kAzca_lepana
flashometer_noun	xamakamApI
flask_noun	PlAska
flatness_noun	samawalawA/niRpraBawA
flats_noun	sapAtikA
flavour_noun	surucika
flaw_noun	BraMSa/xoRa
flex_noun	JukAva
flexibility_noun	lacIlApana/namyawA
flexible_noun	lacIlA/namya
flexure_noun	Anamana
flicker_noun	sPuraNa
flight_noun	udAna
flip-flop_noun	Plipa-PloYpa
floatation_noun	plavana
flocculation_noun	UrNana
flop_noun	PloYpa
flow_noun	pravAha
flowability_noun	pravAhyawA
flowmeter_noun	pravAhamApI
fluctuation_noun	Gata-baDa/uwAra-_caDAva
fluid_noun	warala
fluidifier_noun	waralawAkArI
fluidimeter_noun	waralawAmApI
fluiditization_noun	waralIBavana/waralana
fluidity_noun	waralawA
fluidizer_noun	waraliwra
flume_noun	avanAlikA
fluorescence_noun	prawixIpwi
fluorescent_noun	prawixIpwiSIla/prawixIpwa
fluorimeter_noun	prawixIpwimApI
fluorimetry_noun	prawixIpwimiwi
fluorine_noun	PlorIna
flush_noun	praXAvana/PlaSa/sapAta
flutter_noun	Padaka/PadaPada/Platara/halacala
fluvial_noun	naxIya
flux_noun	aBivAha/Plaksa/gAlaka
flywheel_noun	gawipAlaka_cakra
foam_noun	JAga/Poma/Pena
foamer_noun	PenakArI/JAgakArI
foaming_noun	PenakaraNa/JAgakaraNa
focometer_noun	PokasamApI
focus_noun	Pokasa/Pokasa_karanA
focusing_noun	Pokasana
fog-grain_noun	XunXa_xAnA
fog_noun	kuharA/XunXa
fogdrip_noun	kuharAnamI/XunXanamI
fogging_noun	XunXana/kUhAyana
fold_noun	valana
foliage_noun	parNa_samUha
footrest_noun	pAxASraya/caraNAXAra/Putaresta
forbidden_noun	varjiwa
force_noun	bala
forcing_noun	praNoxana
foreground_noun	agraBUmi
forephase_noun	pUrva_prAvasWA/pUrva_kalA
foreshock_noun	pUrvakampa
forestry_noun	vAnikI
forging_noun	gaDanA/Porjana
formalism_noun	viXAna_vEXikawA/OpacArikawA
format_noun	PArmeta/prArUpa
formation_noun	nirmANa/racanA/viracana/samBavana/samAvAsa/samAsafGa/SElasamUha
forming_noun	samBavana/aBirUpaNa
formula_noun	sUwra
formulate_noun	wEyAra_karanA/nirUpaNa_karanA
fossil_noun	jIvASma
fossorial_noun	KananI
foundation_noun	nIMva/AXAra
founding_noun	visaFcana
foundry_noun	DalAI_Gara/PAuNdrI
fourble_noun	cawurika
foyer_noun	upakakRa
fpga_noun	ePa.pI.jI.e.
fractional_noun	BinnAwmaka/praBAjI/praBAjiwa
fractionation_noun	praBAjana
fractionator_noun	praBAjaka
fracture_noun	viBAjana/viBafga/tUtanA
fragmentation_noun	apaKaNdana
frame_noun	cOKatA/Prema/pUrNa_ciwra/DAzcA
framework_noun	DAzcA/prAXAra
framing_noun	Prema_samaFjana
freezer_noun	praSIwiwra/PrIjara
freezing_noun	himIkaraNa/jamAva
frequency_noun	Avqwwi/bArambArawA/Avqwwi_anwarmAdulana
friction_noun	GarRaNa
frictional_noun	GarRaNI
fringe_noun	PiM_raja/Cora/upAnwa/JallarI
frontage_noun	purABAga
frost_noun	wuRAra
frosting_noun	wuRAraNa
frothing_noun	avaPenana
fuel_noun	IMXana
fugacity_noun	palAyanawA
full-text_noun	pUrNa_pATa
fumigator_noun	XUmaka/XUmiwra
fuming_noun	saXUma/XUmAyamAna
function_noun	Palana/PafkSana/prakArya
fundamental_noun	mUla/mUlaBUwa
funded_noun	viwwapoRiwa/niXibaxXa
funneling_noun	Panalana
furnace_noun	BattI
furnishing_noun	sajjA
fused_noun	saMlIna
fuselage_noun	PyUjaleja/DAFcA
fusibility_noun	galanIyawA/safgalanawA/piGalanIyawA
fusible_noun	safgalanIya
fusion_noun	saMlayana/safgalana
futuristic_noun	BAvI
g-layer_noun	jI-parawa
g-suit_noun	guruwva_poRAka
gadgetry_noun	yukwi/jugawa
galactic_noun	gAfgeya/gEleksIya/manxAkinIya
galaxy_noun	gEleksI/AkASa-_gafgA
gallery_noun	xIrGA/gElarI
galvanization_noun	gElvenIkaraNa
galvanometer_noun	gElvAnomItara/XArAmApI
gantry_noun	gEntrI/sopAnI_maFca
gap_noun	anwarAla/rikwi
gas_noun	gEsa
gasket_noun	gEsketa
gate_noun	xvAra/geta
gauge_noun	pramApa/pramApI/geja
gauging_noun	pramApana
gaussian_noun	gAusIya
gauze_noun	jAlI
gear_noun	giyara
gel_noun	jela
gelatine_noun	jiletina
gelation_noun	jelIkaraNa
gelling_noun	jelana
gemini_noun	jeminI/miWuna
generalisation_noun	vyApakIkaraNa/sAmAnyIkaraNa
generation_noun	pIDI/uwpAxana/janana
genetic_noun	AnuvaMSika
geochronology_noun	BUkAlAnukrama/BUkAlakrama
geocorona_noun	BUkirIta/BU-koronA
geodesic_noun	alpAnwarI/jiyodesika/BUmiwika/BUmApI
geodesy_noun	BUgaNiwa
geoeffective_noun	BUpraBAvI
geographical_noun	BOgolika/BUgolIya
geoid_noun	BU-ABa/jIoYyada/samaguruwva_BUpqRTa
geologist_noun	BUvijFAnI
geology_noun	BUvijFAna
geomagnetic_noun	BUcumbakIya
geometrical_noun	jyAmiwIya
geometry_noun	jyAmiwi/reKAgaNiwa
geomorphological_noun	BU-Akqwika
geomorphology_noun	BU-Akqwi_vijFAna
geostandard_noun	BUmAnaka
geostationary_noun	BUsWira
geosynchronous_noun	BUwulyakAlI
geothermal_noun	BUwApIya
geotropic_noun	guruwvAnuvarwI
getter_noun	getara
giant_noun	bqhaw/mahA/xAnava/viSAla
gimbal_noun	giMbala/Calle
girder_noun	gardara
glacial_noun	himanaxIya
glare_noun	praKarawA/cOMXa
glass_noun	kAzca/glAsa/SISA
glebula_noun	glIbikA
globule_noun	golikA
glove_noun	glava/xaswAnA
glue_noun	saresa
glycerol_noun	glisarAla
goniometer_noun	Palaka_koNamApI/goniyomItara
gordon_noun	goYrdana
governor_noun	niyAmaka/niyanwraka
gradient_noun	pravaNawA
grain_noun	grena/xAnA
grant-in-aid_noun	sahAyawA_anuxAna
granularity_noun	kaNamayawA/kaNIyawA
graphical_noun	AleKI/grAPI
graphite_noun	grePAita
grating_noun	gretiMga
gravics_noun	guruwva_vijFAna/guruwvikI
gravimeter_noun	guruwvamApI
gravitation_noun	guruwvAkarRaNa
gravitational_noun	guruwvI/guruwvIya
gravity_noun	guruwva
grey_noun	XUsara
grid_noun	grida
grill_noun	grila
grinding_noun	pIsanA/sAna
groove_noun	KAzcA
groundwater_noun	BUjala
guestimate_noun	motA_anumAna
guide_noun	paWaka/gAida/mArgaxarSaka
gunpowder_noun	bArUxa
gust_noun	nirGAwa/JoMkA
gypsum_noun	jipsama
gyration_noun	akRa_GUrNana
gyro_noun	jAyaro
gyroelectric_noun	jAyaro_vExyuwa
gyrofrequency_noun	jAyaro_Avqwwi
gyrometer_noun	jAyaromApI
gyroscope_noun	jAyaroskopa/GUrNAkRa_sWApI
gyrostat_noun	jAyarosWApI
h-wave_noun	eca-warafga
hadron_noun	hedrAna
hail_noun	olA
hallmark_noun	pramANacihna/hoYlamArka
halo_noun	praBAmaNdala/pariveSa
halogen_noun	hElojena
hamiltonian_noun	hEmiltanI/hEmiltoniyana
handling_noun	prahaswana
hanger_noun	vimAnaSAlA/hEMgara
hard_noun	kaTora
hardenability_noun	kaToranIyawA
hardening_noun	kaTorIkaraNa/xqDIBavana/suxqDana
hardner_noun	xqDakAraka/kadakArI
hardness_noun	kaTorawA/veXana_kRamawA
hardometer_noun	kaTorawAmApI
hardware_noun	hArdaveyara
harmonic_noun	saMnAxI/prasaMvAxI/hArmonika/harAwmaka
harmonics_noun	guNAvqwwi
harmonization_noun	saMnAxIkaraNa
harmony_noun	sahasvarawA/susvarawA/safgawi/sAmya
harness_noun	sajjA_(upaskara)/hArnesa
harnessing_noun	sajjIkaraNa/prayoga_meM_lAnA
hatch_noun	bAzXa-xvAra
hazard_noun	safkata/joKima
hdtv_noun	ucca_spaRtawA_tIvI_(ecadItIvI)
heading_noun	muKa_xiSA/aBimuKa/SIrRaka
headlight_noun	agraxIpa/hEdalAita
headstart_noun	agrAramBa
heat_noun	URmA
heater_noun	wApaka/hItara
heating_noun	wApana
height_noun	wufgawA/UzcAI
helical_noun	kuNdalinI
helicity_noun	kuNdalawA
helicopter_noun	hElikoYptara
heliocentric_noun	sUryakeMxrI
heliosphere_noun	sUryamaNdala
helium_noun	hIliyama
helmet_noun	helmeta
hematite_noun	hImetAita
hemicycle_noun	arXacakra
hemispherical_noun	arXagolIya
heralding_noun	GoRaNA_karanA
heterodyne_noun	Avqwwi_safkara/hetarodAina
heterogeneous_noun	viRamAfgI_noxaka
hexagon_noun	RatBuja
hibonite_noun	hibonAita
histogram_noun	Ayawa_ciwra
hobbling_noun	kotarana_prakrama
hold-in-phase_noun	sanXAraNa_kalA
hold_noun	XAraNa
hole_noun	Cixra
hollow_noun	KoKalA
hologram_noun	hologrAma
holography_noun	hologrAPI
homing_noun	aBilakRyana
homogeneous_noun	sajAwIya/samAfga/samAfgI/samaGAwa
honeycomb_noun	CawwAkAra/CawwenumA
hooking_noun	saMlagnana
hopper_noun	Puxaka/hoYpara
horizon_noun	kRiwija
horizontal_noun	kREwija/samaswarI/kREwija_wulyakAlana
horn_noun	Sqfga/siMgA
horticultural_noun	bAgabAnI_sambanXI
horticulture_noun	bAgabAnI
hose_noun	hoja
hotspot_noun	wapwa_biMxu
humidity_noun	namI/ArxrawA
hunting_noun	dolana/KojanA
hybrid-t_noun	safkara-tI
hybrid_noun	safkara
hybridisation_noun	safkaraNa
hydraulic_noun	xravacAlikIya/xravacAliwa/calaxravIya
hydraulics_noun	xravacAlikI/hAidroYliksa
hydrazine_noun	hAidrAjIna/hAidrejIna
hydrodynamics_noun	vijFAna/hAidrodAyanemiksa
hydroelasticity_noun	xrava_prawyAsWawA
hydrogen_noun	hAidrojana
hydrogenation_noun	hAidrojanIkaraNa
hydrology_noun	jala_vijFAna
hydrolysis_noun	jala_apaGatana_jala_mOsama
hydrometeorological_noun	vEjFAnikIya
hydrometeorology_noun	jala_mOsama_vijFAna
hydrometer_noun	hAidromItara/uwplava_GanawvamApI
hydroponics_noun	jala_saMvarXana
hydroseparator_noun	xravI_pqWakkiwra
hydrosphere_noun	jalamaNdala
hydrostatics_noun	xravasWEwikI/xravasWiwi_vijFAna/hAidrostEtiksa
hydroxylation_noun	hAidroksilIkaraNa
hygrometer_noun	ArxrawAmApI/hAigromItara
hygroscopic_noun	ArxrawAgrAhI
hygroscopy_noun	ArxrikI
hyperactive_noun	awisakriya
hyperbola_noun	awiparavalaya/hAiparabolA
hypercharge_noun	ucca_AveSa
hypergolic_noun	sparSa_jvalI
hyperplane_noun	aXisamawala
hypersonic_noun	awiXvanika
hypersorption_noun	awicURaNa/awiSoRaNa
hypo_noun	hAipo
hypoblast_noun	aXa:koraka
hypothesis_noun	parikalpanA
hypothesised_noun	parikalpiwa
hysteresis_noun	SEWilya/histerisisa
ice_noun	hima/barPa
iceberg_noun	samuxrI_hima-SEla
iconoscope_noun	mUrwixarSI/Aikonoskopa
ideal_noun	AxarSa
identical_noun	samarUpa/sarvasama/aBinna/samAna
identifier_noun	aBijFAnI/pahacAnI
identity_noun	aBinirXAraNa/wawsamaka/pahacAna_aBijFAna/sarvasamikA/sarvasamawA/vyaRtiwva/pahacAnanA
idler_noun	niRkiyaka/SakwyAnwaraka/alasaka/TAlA
igneo-aqueous_noun	agnijalIya
ignitability_noun	prajvalanIyawA
igniter_noun	prajvAlaka
illumination_noun	praxIpwi
image_noun	prawibiMba
imager_noun	prawibiMbiwra
imagery_noun	imejarI/prawibiMba_ciwra/prawibiMbikI/biMba_vyUha
imaginary_noun	kalpiwa/kAlpanika/aXikalpiwa
imaging_noun	prawibiMbana
imbalance_noun	asanwulana
immeasurable_noun	amApya
immediate_noun	wawkAla
immerse_noun	dubAnA/DakanA/nimajjana
impact_noun	safGatta/takkara/praBAva
impedance_noun	prawibAXA
impedometer_noun	prawibAXAmApI
impeller_noun	Avejaka
impenetrability_noun	aBexyawA
impinge_noun	AGatta/takarAnA
impingement_noun	takarAva/AGattana
implement_noun	OjAra/sAXana
implementation_noun	kAryAnvayana/kriyAnvayana
implication_noun	nihiwArWa
implosion_noun	anwarmuKI_sPota/anwa:sPota
impregnation_noun	saMsecana
imprint_noun	CApa/aXicihna/aXimuxraNa
impulse_noun	Avega
incidence_noun	Apawana
incident_noun	Apawiwa/GatanA
incipient_noun	ArabXa/prAramBI/AramBI
inclination_noun	nawi/JukAva/Anawi
incline_noun	JukAva/Anawa
inclined_noun	nawa
included_noun	anwarviRta
inclusion_noun	samAveSa/anwarveSana
incoherent_noun	asambaxXa/asafgawa
inconsistency_noun	asafgawawA
incrementation_noun	aMSavqxXi
indeed_noun	vAswava_meM
index_noun	GAwAfka/sUcaka/sUcakAfka
indexer_noun	sUcakAfka/nirxeSikA
indicate_noun	sUcana/iMgiwa/sUciwa_karanA
indicating_noun	sUcaka/saMsUcaka
indication_noun	safkewa
indigenous_noun	svaxeSI
inductor_noun	preraka
inelastic_noun	aprawyAsWa
inequality_noun	asamawA/asamikA
inert_noun	akriya/jada
inertia_noun	jadawva
inertial_noun	jadawvIya
inface_noun	kagAramuKa
inference_noun	anumAna/anumiwi
infested_noun	graswa
inflation_noun	muxrA_sPIwi/havA_BaranA
inflationary_noun	sPIwika/sPIwikArI
inflexion_noun	nawi_parivarwana
influence_noun	praBAva/asara
informative_noun	sUcanAparaka/sUcanAwmaka
infrared_noun	avarakwa
infrasonic_noun	avaSravya
infrasonics_noun	avaSrAvikI
infrastructure_noun	DAFcAgawa
ingot_noun	SilikA/nipiMda/sillI
ingredient_noun	safGataka/upAxAna
inherent_noun	anwarniRTa/anwarnihiwa/nihiwa
inhibit_noun	niroXa/xamana
inhibition_noun	sanxamana/niroXa/niroXana
inhibitor_noun	niroXI/niroXaka/sanxamaka
inhomogeneity_noun	asamAfgawA
inhomogeneously_noun	asamAfgI
inhomogeneoustransformer_noun	asamAfgI_trAMsaPArmara
initial_noun	prAramBika/Axi
initialization_noun	prAramBana
initiate_noun	Su_digrI_karanA/prAramBa_karanA
initiation_noun	prAramBana
initiative_noun	pahala
initiator_noun	prAramBaka
injected_noun	anwa:kRipwa
injecting_noun	anwa:kRepI
injection_noun	anwa:kRepaNa
injector_noun	anwa:kRepiwra
inlet_noun	praveSikA
innovation_noun	navapravarwana/navInIkaraNa
inorganic_noun	ajEva/akArbanika
input_noun	niveSa/inaputa
insensitive_noun	asaMvexanaSIla
insert_noun	niviRta/bETAnA
insertion_noun	niveSana/anuwiRTana
instability_noun	asWAyiwva/asWirawA
institutional_noun	saMsWAgawa
instruction_noun	anuxeSa
instrument_noun	sAXiwra/OjAra/yanwra
instrumentation_noun	yanwra/yanwrIkaraNa/pariSuxXa_sAja
insulated_noun	URmAroXI/wAparoXI
insulation_noun	roXa/roXana
insulator_noun	roXI/vixyuwaroXI
intake_noun	anwargrahaNa
integral_noun	samAkala/pUrNAfkIya/aBinna
integrated_noun	samAkaliwa/samekiwa
integration_noun	ekIkaraNa/samAkalana
intend_noun	uxxeSya/irAxA_karanA
intensifier_noun	prakarRaka/wIvraka
intensitometer_noun	wIvrawAmApI
intensity_noun	prabalawA/wIvrawA
inter-communication_noun	anwarA-saFcAra
interaction_noun	anyonyakriyA/pArasparikakriyA
interatomic_noun	anwarAparamANu
interchangeability_noun	anwarparivarwanIyawA/axalA-baxalI
intercorrelation_noun	paraspara_sahasambanXa
intercosmos_noun	anwarabrahmANda
interface_noun	anwarApqRTa
interfacing_noun	anwarApqRTana
interference_noun	vyawikaraNa
interferograms_noun	vyawikaraNaleKa
interferometer_noun	vyawikaraNamApI/iMtaraPeromItara
interferometry_noun	vyawikaraNamiwi
intergranular_noun	anwarAkaNika
interior_noun	aByanwara/anwarafga/anwa:anwargUDa/Anwarika/anwa:sWa
interlace_noun	anwargraWana/anwargraWa
intermediate_noun	maXyavarwI/mAXyamika/maXya/maXyaka
intermediatetemperature_noun	maXya_wApa
intermodulation_noun	anwarAmoYdulana
intermolecular_noun	anwarANuka
internal_noun	Anwara/Anwarika/aByanwara
interplanetary_noun	anwarAgrahIya
interpolate_noun	anwarveSana
interpret_noun	vyAKyA_karanA/arWa_bawAnA/nirvacana_karanA
interpretation_noun	arWa_nirvacana/arWa_lagAnA/arWa_vAcana
interpreter_noun	iMtarapretara/arWa-_nirvacaka
interradial_noun	anwarArIya/anwara_wrijyIya
interrupt_noun	viGna/anwarAyana
interstage_noun	anwarAcaraNa/anwaracaraNa
interstellar_noun	anwarAwArakIya
interstitial_noun	anwarAlI/anwarAkASI
intersymbol_noun	anwarAprawIka
interval_noun	anwarAla/anwara
intervalometer_noun	anwarAlamApI
intra_noun	anwa:/Anwara
intrinsic_noun	nEja/sahaja/Anwarika
introvert_noun	anwarmuKI
invariable_noun	aparivarwI/acara
invention_noun	AviRkAra
inventory_noun	mAla_sUcI/inaveMtarI
inverse_noun	vyuwkrama/viparIwa/prawiloma
inversely_noun	vyuwkrama/viparIwa/prawiloma
inverter_noun	parivarwaka/prawIpaka
investigated_noun	anveRiwa
investigation_noun	anveRaNa/jAzFca
investment_noun	sanniveSa/niveSa
inviolate_noun	akRawa
involve_noun	sammiliwa_karanA/SAmila_karanA
iodised_noun	Ayodiwa
ionisation_noun	Ayanana
ionogram_noun	AyanaleKa/AyanogrAma
ionosonde_noun	Ayanosonde
ionosphere_noun	Ayana_maNdala/AyanosPiyara
ire-scale_noun	AI.Ara.I-skela
irradiance_noun	kiraNanawA
irradiation_noun	kiraNana
irregularity_noun	aniyamiwawA
irrigation_noun	siMcana/siMcAI
isentropic_noun	AisenatrApI/samaEnatrApika
isobar_noun	samaxAba_reKA
isobutane_noun	AisobyUtena
isochore_noun	samaAyawanika_reKA
isochromatic_noun	samavarNaka/samavarNI
isoclinic_noun	samanawa
isoentropic_noun	samaEntrApika/AisoEntrApika
isogam_noun	samaguruwvI
isolation_noun	viyojana/vilagana/pqWakkaraNa/pArWakya
isolator_noun	pqWakkArI/vilagaka/vilagiwra
isomerism_noun	samAvayavawA
isomorphism_noun	wulyakAriwA
isomorphous_noun	samAkqwika/prAcalika
isopleth_noun	samamAna_reKA
isopolar_noun	samaXruvI
isopycnal_noun	Aisopiknala/samaGanawva
isoradial_noun	samawrijya
isostatic_noun	samasWEwika
isotherm_noun	samawApa_reKA
isothermal_noun	samawApI
isotope_noun	samasWAnika/samaprotAnika/Aisotopa
isotopic_noun	samasWAnika
isotropic_noun	samaxESika/samAnuvarwI
isotropy_noun	samaxESikawA
iteration_noun	punarAvqwwi
jack_noun	jEka
jacket_noun	jEketa
jamming_noun	sambAXana/jAma_honA
jet_noun	praXAra/jeta
jetavator_noun	jetAvetara
jig_noun	jiga
jimsphere_noun	jimasPIyara
joint_noun	saMyukwi/joda/sanXi
joule_noun	jUla
junk_noun	kabAda
k-band_noun	K-bEMda
k-function_noun	K-Palana
kerosene_noun	mittI_kA_wela/kerosina
key_noun	kuFjI
keying_noun	kuFjIyana
kick_noun	prakRepa/GAwa
kiln_noun	BatTA
kinematic_noun	SuxXa_gawika
kinematically_noun	SuxXa_gawikawa:
kinematics_noun	SuxXagawikI/SuxXagawi_vijFAna
kinetic_noun	gawika
kinetics_noun	balagawikI/balagawi_vijFAna
kneader_noun	gunxiwra/gunXane/gunXaka_kI_maSIna
knurling_noun	narlana/gAzTa_lagAnA/tIcA_lagAnA
ku-band_noun	KCa_-bEMda/kU-bEMda
l-band_noun	Kr_-bEMda
l-section_noun	L_-_paricCexa
label_noun	lebala
laboratory_noun	prayogaSAlA
ladder_noun	sIDI/sopAna
laguerre_noun	lAgera
lamelloid_noun	patalikABa
laminar_noun	patalIya
laminate_noun	patalana
lamp_noun	lEMpa/xIpa
landing_noun	avawaraNa
landmass_noun	BUKaNda/BU-xqSya
landsat_noun	lEMdasEta
landscape_noun	BU-parixqSya
landscaping_noun	BUxarSanIkaraNa/BUxqSya
landslide_noun	BU-sKalana
lap_noun	lEpa/sUkRma_GarRaNa/CAxana
lapping_noun	lEpana/sUkRma_GarRaNa
lapse_noun	wruti
laser-electron_noun	lesara-ilektrAna
laser_noun	lesara/lejara
lasing_noun	lesana/lesarIkaraNa
latch_noun	sitakanI
latency_noun	anwarnihiwawA/prasupwi_kAla
latent_noun	avyakwa/pracCanna/prasupwa/gupwa
latitude_noun	akRAMSa
lattice_noun	jAlaka
launch_noun	pramocana
launcher_noun	pramocana_yAna/pramociwra/pramocaka
launching_noun	pramocana
layer_noun	parawa/swara
layout_noun	aBivinyAsa/le_Auta
leaching_noun	nikRAlana
lead_noun	cAlaka_wAra/sirA
leakage_noun	kRaraNa/lIka
lease_noun	pattA
legend_noun	nixeSikA
lens_noun	lensa/wAla
leonid_noun	siMhasWa
leptogenesis_noun	leptoYna_janyawA
lepton_noun	leptoYna
level_noun	wala/swara/samawala
life_noun	Ayu/jIvana
lift_noun	uwWApaka/liPta
lifting_noun	uwWApana
light_noun	prakASa/halkA/alpa/laGu
lightning_noun	wadiw
limb_noun	xalana-Palaka/bAhu/afga/pAva
limit_noun	sImA
limiter_noun	sImaka
limonitic_noun	limonitika
linear_noun	rEKika
linearity_noun	ekaGAwawA/rEKikawA
liner_noun	Aswaraka/paricCAxI/aswara
link_noun	kadI/SqfKalA/banXa
linkage_noun	sahalagnawA/banXawA/kadI_banXawA
liquefaction_noun	xrAvaNa/xravaNa
liquid_noun	xrava
list_noun	sUcI
literature_noun	sAhiwya
lithography_noun	aSmamuxraNa/liWomuxraNa
lithology_noun	aSmavijFAna/SEla_vijFAna
lithometer_noun	liWomApI/aSmamApI
lithosphere_noun	sWala_maNdala/liWomaNdala
loader_noun	BAraka/smqwi_BAraka
lobe_noun	pAli/KaNda/piMda
localised_noun	sWAnagawa/sWAnIyiwa/sWAna_sImiwa/sWAnika
localization_noun	sWAnIkaraNa/sWAna_nirXAraNa
location_noun	sWAna_nirXAraNa
locking_noun	pASana/aBibanXI
locomotion_noun	gamana/calana
locust_noun	tiddI
logarithmic_noun	laGugaNakIya/loYgeriWmIya
logging_noun	saMleKana
loitering_noun	paWewara-udAna/loYyatarana
longeron_noun	loMgaroYna
longitude_noun	reKAMSa/xeSAnwara
longitudinal_noun	xeSAnwarIya/anuxErGya/akRIya
loop_noun	lUpa/pASa/PanxA
loose_noun	SiWila/DIlA
lorentz_noun	lorentja
louver_noun	praPalaka/pattInumA/JilamilI
lox_noun	xrava_oYksIjana/loYksa
lubricant_noun	snehaka
lubrication_noun	wela_xenA/snehana
lubricator_noun	snehaka
lubricity_noun	snehakawA
luminescence_noun	sanxIpwi
luminosity_noun	jyowi/camaka
lyosphere_noun	pravamaNdala
machine_noun	maSIna/yanwra/kala
macro-instability_noun	sWUla_asWAyiwva
macroassembler_noun	sWUla_kodAnwaraka
macrodomain_noun	sWUla_prakRewra
macroscopic_noun	sWUlaxarSI
macrostate_noun	sWUlaavasWA
magazine_noun	bArUxa_KAnA/bArUxa_gqha/mEgajIna
magenta_noun	PAlasAI/mEjentA
magic-t_noun	safkara-/mEjika-_cr_cr
magnesia_noun	mEganISiyA
magnet_noun	cumbaka
magnetic_noun	cumbakIya
magnetically_noun	cumbakawvI/cumbakIyawa:
magnetisation_noun	cumbakana
magnetism_noun	cumbakawva
magneto-dynamics_noun	cumbakIya_gawikI
magneto-stratigraphic_noun	cumbakIya_saMswarika/cumbakIya_swarika
magnetogram_noun	mEgnetogrAma/cumbakaleKa
magnetograph_noun	mEgnetogrAPa/cumbakaleKI
magnetography_noun	cumbaka_aBileKana
magnetometer_noun	cumbakawvamApI/cumbakawvamiwi
magnetopause_noun	cumbakawvI_maNdala_sImA
magnetoscope_noun	cumbakawvaxarSI
magnetosphere_noun	cumbaka_maNdala
magnetostatic_noun	sWiracumbakIya
magnetostriction_noun	cumbakIya_virUpaNa
magnification_noun	AvarXana
magnitude_noun	parimANa/kAnwimAna
maiden_noun	pahalA
main-stay_noun	muKya_AXAra
maintenance_noun	anurakRaNa
major_noun	xIrGa/guru/muKya
majority_noun	bahusafKyaka
malfunction_noun	kusafkriyA/wruti_pUrNa_kriyA
malleability_noun	AGAwavarXyawA
mandrel_noun	mendrela/xaNdaka
manifest_noun	vyakwa
manifestation_noun	aBivyakwi
manifold_noun	bahumuKa
manoeuvrability_noun	yukwi_kOSalya
manoeuvre_noun	kOSala
manoeuvring_noun	yukwi_saMsAXana
manometer_noun	mEnomItara/xAbAnwaramApI
manpower_noun	mAnava_Sakwi
manufacture_noun	nirmANa/uwpAxana/Oxyogika
mapping_noun	mAnaciwraNa/prawiciwraNa/BUmApana
marine_noun	samuxrI/sAgarI
mariner_noun	merinara/nAvika
marisat_noun	merisEta/samuxra_sambanXI_jAnakArI_upagraha
maritime_noun	samuxrI
mars_noun	mafgala/mArsa
martensite_noun	mArtensAita
martian_noun	mafgalI/mafgalagrahI
mashing_noun	masalanA
mask_noun	mAska/AvaraNa/pracCAxa/muKOtA
masking_noun	pracCAxana
mass_noun	xravyamAna/saMhawi
massive_noun	saMsWUla/sampuFjiwa/sWUla/BArI
matching_noun	sumelana
material_noun	sAmagrI/xravya/paxArWa/vaswu
mathematical_noun	gaNiwIya
matrix_noun	AvyUha/mEtriksa
maximally_noun	aXikawama
maximum_noun	mahawwama/aXikawama/uccawama
mean_noun	mAXya/Osawa
measurement_noun	mApana/mApa/nApa/mApI/mApaka
mechanical_noun	balakqwa/yAnwrika/samparkI
mechanics_noun	balavijFAna/yanwravijFAna/yAnwrikI
mechanism_noun	kriyAviXi/yanwrAvalI/kala
meggar_noun	megara
melting_noun	piGalanA/galana
membrane_noun	JillI
memory_noun	smqwi
mercury_noun	buXa/markarI/pAraxa/pArA
meriblastic_noun	aMSakoraka
meridian_noun	Xruvavqwwa/yAmyowwara
meridional_noun	reKAMSika/yAmyowwarIya
mesh_noun	jAla
mesomorphic_noun	maXyAkqwi/maXya_Akqwika
meson_noun	mesoYna
mesopause_noun	maXya_sImA
mesosphere_noun	maXya_maNdala
mesospheric_noun	maXya_maNdalIya
mesotron_noun	mesotroYna
mesozoic_noun	maXyajIvI
metabond_noun	XAwubanXaka
metal_noun	XAwu
metallisation_noun	XAwulepana
metallising_noun	XAwu_lepana
metallography_noun	XAwu_ciwraNa
metaphysics_noun	wawvamImAMsA
metastable_noun	miwasWAyI
metatropy_noun	BOwika_rUpAnwaraNa
meteor_noun	ulkA
meteoric_noun	vAyumaNdalIya/ulkIya
meteorite_noun	ulkA_piMda
meteoritical_noun	ulkApiMdIya
meteoroid_noun	ulkABa
meteorologist_noun	mOsama_vijFAnI/mOsamajFa/mOsamavix/mOsama_vEjFAnika
meteorology_noun	mOsama_vijFAna
meteosat_noun	mItiyosEta
methane_noun	mIWena
method_noun	viXi/rIwi
methylamine_noun	meWilEmIna/mIWAilaamina
methylosis_noun	rAsAyanika_anwaraNa/meWilIkaraNa
micro-level_noun	sUkRma_swara
micro_noun	mAikro/sUkRma/laGu
microbeam_noun	sUkRma_kiraNa_puFja
microbial_noun	sUkRmajIvI
microcomputer_noun	mAikro_kampyUtara/sUkRma_aBikaliwra
microhardness_noun	sUkRma_kaTorawA
micrometeorite_noun	sUkRma_ulkA_piMda
micron_noun	mAikroYna
microphone_noun	mAikroPona
microphonics_noun	mAikroPonikI/mAikroPonI_rava
microprobe_noun	mAikroproba
micropulsation_noun	sUkRma_spanxana
microscope_noun	mAikroskopa/sUkRmaxarSI
microsecond_noun	mAikrosekaNda
microsection_noun	sUkRma_paricCexa
microstrip_noun	sUkRma_pattI
microtherm_noun	sUkRmawApI
microwave_noun	sUkRmawarafga/sUkRmawarafga_parijFApI
mid-cretaceous_noun	maXya-kreteSiyasa
migration_noun	aBigamana/pravAsana
mil_noun	mila_(iMca_kA_hajAravAz_BAga)
mill_noun	mila/cakkI/peRanI
milling_noun	peRaNa/miliMga
millisecond_noun	milI_sekaNda
mineral_noun	Kanija
mineralogical_noun	KanijIya
minimization_noun	nyUnawamIkaraNa
mirror_noun	xarpaNa
misalignment_noun	kureKaNa/kusaMreKaNa/kusaMreKana
misclosure_noun	samApana_aSuxXi/samApana_galawI
misfire_noun	paWaBraRtana/avisPotana
mismatch_noun	kumela
missile_noun	misAila/prakRepAswra
mission_noun	aBiyAna/miSana
mist_noun	kuhAsA/XUmikA
mitigation_noun	nyUnIkaraNa/Samana
mixer_noun	miSriwa_yanwra
mixing_noun	miSraNa/milAnA
mobility_noun	gawiSIlawA
mobilization_noun	gawiSIlana/AhvAna
mode_noun	rIwi/viXA
model_noun	moYdala/nixarSa
moderate-sized_noun	maXyama_AkAra
modest_noun	sanwuliwa/sAXAraNa
modification_noun	aparivarwana
modified_noun	Aparivarwiwa/AsaMSoXiwa
modifier_noun	rUpAnwariwra/rUpAnwaraka/Aparivarwika
modular_noun	mAdulI_prawirUpaka/upAfga
modulation_noun	mAdulana
modulator_noun	mAdulaka
module_noun	moYdyUla/mAdyUla/prawirUpaka
modulo_noun	mAdyUlI
modulus_noun	mAdyUlasa/mApAfka
moire_noun	mvAra
moisture_noun	namI/ArxrawA
mole_noun	grAma_aNu
molecular_noun	ANvika
molecule_noun	aNu
molniya_noun	molaniyA_(rUsI_upagraha)
moment_noun	AGUrNa
momentum_noun	saMvega
monitor_noun	moYnItara/moYnItara_karanA
monitored_noun	moYnItariwa
monochromator_noun	monokrometara/ekavarNaka
monochrome_noun	ekavarNI
monofilament_noun	ekawanwuka
monomer_noun	ekalaka
monopole_noun	eka_Xruva
monopropellant_noun	ekAfgI_noxaka/ekala_noxaka
monotonically_noun	ekaxiRtawa:
moon_noun	canxramA
morphological_noun	Akqwika/AkArikIya/AkArika
morphology_noun	AkqwivijFAna/AkArikI
motion_noun	gawi
motor_noun	motara
mottled_noun	ciwakabarA
mould_noun	saFcaka/sAzcA
moulding_noun	saFcakana
mounting_noun	sWApana/AropaNa/sWApanA/vyavasWA
multicarrier_noun	bahuvAhaka
multicomponent_noun	bahuafgI_noxaka
multidirectional_noun	bahuxESika
multilevel_noun	bahuswarI
multimeter_noun	bahumApI
multipactor_noun	maltIpEktara/bahusaMroXaka
multiple_noun	guNiwa/bahu
multiplexer_noun	bahusafkewaka
multiplexing_noun	bahusafkewana
multiplicity_noun	bahukawA
multiprocessing_noun	bahu_prakramaNa
multistage_noun	bahucaraNa/bahupaxI/bahupaxa
multistrand_noun	bahuXArI/bahuwanwuka
multivibrator_noun	bahukampiwra
murchison_noun	marcisana_(ulkApiMda
mutual_noun	pArasparika/anyonya
mystery_noun	gUDawva/gUDawA/rahasya
n-butane_noun	N-byUtena
n-terminal_noun	N-tarminala
nano-particle_noun	nEno_kaNa
nanometer_noun	nEnomItara
nanosecond_noun	nEno_sekeMda
natural_noun	svABAvika/prAkqwika/prAkqwa
naturalization_noun	prakqwikaraNa
nature_noun	prakqwi/svaBAva/svarUpa
navigation_noun	nOsaFcAlana/nOcAlana
nebula_noun	nIhArikA
necessary_noun	AvaSyaka
negator_noun	niReXaka
negentropy_noun	qNAwmaka_EntrApI
neighbourhood_noun	prawiveSa/sAmIpya/padOsa
neighbouring_noun	sAmIpya
neon_noun	nioYna
nephoscope_noun	naBoxarSI/meGaxarSI
neptune_noun	nepc_yUna/varuNa
nesistor_noun	nejistara
nesting_noun	nIdana
network_noun	jAla/jAlakrama
neuristor_noun	nyUristara
neutral_noun	niRpraBAvI/nirAveSI
neutrino_noun	nyUtrino
neutrinoless_noun	nyUtrinohIna/nyUtrinorahiwa
neutrodyne_noun	nyUtrodAina
neutron_noun	nyUtroYna
neutropause_noun	uxAsIna_maNdala_sImA
neutrosphere_noun	uxAsIna_maNdala
nimbus_noun	niMbasa/praBAmaNdala
nitrogen_noun	nAitrojana
nitromethane_noun	nAitromiWena
nitrosation_noun	nAitrosIkaraNa/nAitroseSana
nixie_noun	niksI
node_noun	noda/nispanxa/nirnawi
nodular_noun	granWika
nodulizing_noun	granWana/granWIkaraNa
noise_noun	rava
noisiness_noun	ravawA
nomenclature_noun	nAma_paxXawi/nAmAfkana_paxXawi/nAmakaraNa_paxXawi
non-boussinesq_noun	abUsanI
non-chromaticradiation_noun	avarNI_vikiraNa
non-circular_noun	avqwwIya
non-coiling_noun	akuNdalana
non-conductivecoupling_noun	acAlakIya_yugmaka
non-conservative_noun	asaMrakRI/aparipAtI
non-diffusible_noun	avisaraNaSIla
non-dissipative_noun	UrjA_saMrakRI
non-dissociating_noun	aviyojI
non-geostrophic_noun	aBUvikRepI
non-interacting_noun	anyonyakriyAhIna
non-optimal_noun	iRtawamewara
non-perturbative_noun	akRubXI
non-reflecting_noun	aparAvarwI
non-stationary_noun	sacala/asWira/apragAmI
non-symmetry_noun	asamamiwi
nonadiabatic_noun	aruxXoRma
nonadiabaticity_noun	aruxXoRmawA
nonlinearity_noun	arEKikawA
nonluminous_noun	jyowivihIna/nirjyowi
nonsolvent_noun	avilAyaka
nonsparking_noun	asPuliMgI
normal_noun	prasAmAnya/aBilamba
normality_noun	nArmalawA/prasAmAnyawA
normalization_noun	prasAmAnyIkaraNa
northern_noun	uwwarI
notation_noun	safkewana/afkana/safkewa_paxXawi/afkana_paxXawi
notch_noun	KAFca
nova_noun	navawArA/novA
nozzle_noun	noYjala/wuNda/caFcu
nuclear_noun	nABikIya/nyUklIya/keMxraka/keMxrikI/nABika
nucleation_noun	nABikana
nucleosynthesis_noun	nABikI_saMSleRaNa
nuclide_noun	nyUklida/nABikI
nugget_noun	nageta/jaloDa
nutation_noun	akRa_vicalana/SiKA_cakraNa
nutshell_noun	safkRepa
object_noun	vaswu/piMda
objective_noun	aBixqSyaka/vaswuniRTa/uxxeSya
oblique_noun	wiryak/wiraCA
obscuration_noun	AcCAxana
observability_noun	prekRaNIyawA
observable_noun	prekRaNIya
observation_noun	prekRaNa/avalokana
observatory_noun	veXaSAlA/AbjarvetarI
observe_noun	prekRaNa
obsolescence_noun	apracalana
obsolescent_noun	lupwaprAya
obsolete_noun	lupwa/apracaliwa
obtainability_noun	prApyawA
obtained_noun	prApwa
obturator_noun	gavAkRa
occultation_noun	upagUhana/AcCAxana
occupancy_noun	niveSana
occur_noun	Gatiwa_honA/pAyA_jAnA
occurrence_noun	prApwi/upasWiwi/GatanA
oceanographic_noun	samuxravijFAna_sambanXI
oceanography_noun	samuxravijFAna
octave_noun	aRtaka
octet_noun	aRtaka/ataTA
ogive_noun	woraNa/ojAiva
omnidirectional_noun	sarvaxESika/sarvaxiSa
omnidirectionality_noun	sarva_xiSawA/sarva_xESikawA
ondograph_noun	OMdogrAPa/voltawA_warafgaleKI
opaque_noun	apAraxarSI/apArya
operand_noun	safkArya
operation_noun	safkriyA/pracAlana/ApareSana
operationalise_noun	pracAlanIkaraNa
operator_noun	safkAraka
opportunity_noun	avasara
optical_noun	prakASIya/prakASika/prakASI
optimisation_noun	iRtawamIkaraNa
optimize_noun	iRtawama_karanA/anukUlawama_karanA
optimum_noun	anukUlawama/iRtawama
ora_noun	Cixraka
orbit_noun	kakRA
orbital_noun	kakRaka/kakRIya
orbiter_noun	kakRIyAna/kakRiwra
ore_noun	ayaska
orientation_noun	aBivinyAsa/JukAva/aBimuKIkaraNa
oriented_noun	vinirxiRta
orifice_noun	vivara_xvAra
origin_noun	uxgama/mUlabiMxu
orography_noun	parvawavijFAna/parvawikI
orthicon_noun	oYrWikoYna
orthogonal_noun	lAmbika/lambakoNIya
orthogonality_noun	lAmbikawA/lambakoNIyawA
oscillation_noun	xolana
oscillator_noun	xoliwra
oscillatory_noun	xolanI
oscillogram_noun	xolanaleKa/oYssilogrAma
oscillography_noun	xolana_ciwraNa/oYsalogrAPI
osmometer_noun	parAsaraNamApI
outage_noun	bahiraMSa/niRkriyawA
outcome_noun	pariNAma
outcrop_noun	xqSyAMSa
outgassing_noun	apagEsana/vigEsana
outlay_noun	lAgawa/parivyaya
outlet_noun	nirgamikA
output_noun	nirgama/bahirveSa/uwpAxana/nirgawa
oval_noun	aNdAkqwi/aNdAkAra
oven_noun	AMvA/avana/banxa_cUlhA/BattI
overcast_noun	aXiDalA/meGAcCanna/meGAcCAxiwa
overcompensated_noun	awi_prawipUriwa
overflow_noun	Aplava/aXipravAha
overhead_noun	Siropari
overlap_noun	awivyApana/awivyApwi
overlapping_noun	awivyApana
overload_noun	aXiBAra
overpressure_noun	awixAba
overscan_noun	aXikramavIkRaNa
overshoot_noun	awikramaNa/aXikarRa
overtone_noun	aXisvaraka/aXiCavi
oxidation_noun	oYksIkaraNa/upacayana
oxide_noun	oYksAida
oxidizer_noun	oYksIkAraka
oxygen_noun	oYksIjana
oxyntic_noun	amlajana
ozone_noun	ojona
p-band_noun	G_-bEMda
pachymeter_noun	motAImApI
pacific_noun	praSAnwa_(mahAsAgara)
package_noun	pEkeja
packing_noun	saMveRtana/safkulana/pEkiMga
pacor_noun	pEkoYra
paddle_noun	pEdala/kRepaNI
paint_noun	penta/pralepa
pairing_noun	yugalana/yugmana
palaeomagnetic_noun	purAcumbakIya
paleoclimatic_noun	purAjalavAyavIya
paleoenvironmental_noun	purAvAwAvaraNIya
paleoproductivity_noun	purAuwpAxakawA
panchromatic_noun	sArvavarNI_eriyala
panoramic_noun	parixqSya
pantograph_noun	pEMtogrAPa/vixyuwagrAhI
parabola_noun	pErAbolA/paravalaya
parabolic_noun	paravalayika
paraboloid_noun	pErAboloYida/paravalayaja
parachor_noun	pErAkora
parachute_noun	havAI_CawarI/pErASUta/avawaraNa_CawarI
paradigm_noun	uxAharaNa/xqRtAnwa
parallax_noun	lambana/pErelEksa
parallel_noun	samAnAnwara/samAnwara
parameter_noun	prAcala/anwa:KaNdI_anupAwa/pErAmItara
parameterized_noun	prAcaliwa
parametric_noun	prAcalI/prAcalika
parametron_noun	pErAmetroYna
parenthesis_noun	koRTaka/banXanI
parsec_noun	pAraseka(badI_xUrI_mApaka_ikAI)
partial_noun	AMSika/KaNda
partially_noun	aMSawa:/AMSika_rUpa_se
particle_noun	kaNa
particulars_noun	viSeRa_vivaraNa/byOrA/vivaraNa
partition_noun	viBAjana_krometogrAPI
partnership_noun	BAgIxArI
pass_noun	pAraNa_pAragamana
passive_noun	niRkriya/parakriya
paste_noun	lehI/leI
patch_noun	swabaka/cappA/pEca
patens_noun	viswArI_petenta
pause_noun	virAma
payload_noun	nIwaBAra/praxAyaBAra/peloda
pebble_noun	gutikA/kafkada/gotI
pecos_noun	pekoYsa
pellet_noun	tikiyA/gutikA/pEleta
pendulum_noun	lolaka
penetration_noun	veXana
peninsula_noun	prAyaxvIpa
pentane-methane-_noun	pentena-mIWena-propena
penumbra_noun	upacCAyA
perfection_noun	pUrNawA
performance_noun	niRpAxana
periastron_noun	wArAnIca/upawAraka
perigee_noun	upaBU
periglacial_noun	parihimanaxa/parihimAnI/parihimanaxIya
period_noun	AvarwakAla/avaXi/kAla/Avarwaka/AvarwanAfka/kAlAfka
periodicity_noun	AvarwiwA/AvaXika
peripheral_noun	pariXIya_saMsAXana
peritectic_noun	peritektika/parikrAnwika
perlite_noun	parlAita
permeability_noun	cumbakaSIlawA/pAragamyawA
permeation_noun	pAragamana
persistence_noun	xqDawA/sAwawya/nirbanXa
perturbation_noun	kRoBa
petaloid_noun	xalABa
phanerozoic_noun	PEnerojoika/xqSyajIvI
phase_noun	kalA/prAvasWA/kalA;_koNAfka;_caraNa
phaser_noun	kalAsamaFjaka
phenol_noun	PInoYla
phenology_noun	GatanAvijFAna
phenomenon_noun	pariGatanA/GatanA
phenophase_noun	PenoPeja
phosphate_noun	PoYsPeta
photobase_noun	ciwrAXAra
photocell_noun	prakASa_sela/Poto_sela
photocopy_noun	PotokApI
photodiode_noun	prakASa_dAyoda/PotodAyoda
photoelastic_noun	prakASa_prawyAsWa
photoelasticity_noun	prakASa_prawyAsWawA
photogrammetry_noun	Poto_grAmiwi
photograph_noun	havAI-Poto
photographp_noun	PotogrAPa
photography_noun	PotogrAPI
photogrid_noun	Poto_grida
photoionization_noun	prakASa_Ayanana
photolysis_noun	prakASa-apaGatana
photometer_noun	prakASamApI/PotomItara
photometric_noun	prakASamApIya/prakASamiwIya
photometry_noun	prakASamiwi
photomultiplier_noun	prakASa_guNiwra/prakASa_guNaka
photon_noun	PotoYna
photosphere_noun	prakASa_maNdala
photostage_noun	xIpwi_avasWA
photosynthesis_noun	prakASa_saMSleRaNa_BOwika
physics_noun	BOwikI/BOwika_vijFAna
phytoplankton_noun	pAxapaplavaka
piezometer_noun	xAbamApI
pigment_noun	varNaka/raFjaka
pigtail_noun	wAra_gumPana
pinking_noun	visravaNa
pioneer_noun	agresara/aguA/paWa-praxarSaka/pAyaniyara
pipe_noun	nalikA/nala/nalI/pAipa
piston-ring_noun	pistana-CallA/pistana_riMga
pit_noun	garwa/gadDA
pitch_noun	cUdI/anwarAla/wArawva/akRanawi/xUrI/peMcaxUrI/pica
pitcher_noun	Gata/GadA
pitching_noun	akRanamana
plagioclase_noun	plejioklesa
plane_noun	samawala/wala
planet_noun	graha
planetarium_noun	kqwrima_naBomaNdala/kqwrima_naBamaNdala
planetary_noun	grahIya
planetesimal_noun	grahANu/sUkRma_graha
planetoid_noun	kRuxra_graha
plank_noun	Palaka/plEMka
plankton_noun	plavaka_(jIva)_plEMkatana
plasma_noun	plAjmA
plasmatron_noun	plAjmAtroYna
plastic_noun	suGatya/plAstika
plasticate_noun	suGatana
plasticity_noun	plAstikawA/suGatyawA
plasticizer_noun	plAstikArI/suGatyawAkArI
plastigel_noun	plAstijela
plastisol_noun	plAstisoYla
plate_noun	pattikA/pleta
platform_noun	maFca/pletaPArma
pleistocene_noun	plAistosIna
plotter_noun	AleKiwra
plumbing_noun	nalasAjI
plunger_noun	nimajjaka/plaFjara
pluto_noun	plUto
pneumatics_noun	gEsa_yAnwrikI
pogo_noun	pogo
pointer_noun	safkewaka/sUcaka
polar_noun	XruvIya
polarimeter_noun	XruvaNamApI
polarimetry_noun	XruvaNamApana
polarisation_noun	XruvaNa
polariscope_noun	XruvaNaxarSI
polariser_noun	Xruvaka/polarAijara
polarity_noun	XruvawA
polarizability_noun	XruvaNIyawA
polarize_noun	XruvaNa_karanA
polarogram_noun	XruvaNa_leKa/polerogrAma
polarograph_noun	XruvaNaleKI/polerogrAPa
polarography_noun	XruvaNa_leKa/polerogrAPI
polishing_noun	pAliSa_karanA/cakAsana
polybinary_noun	bahuxviAXArI/bahuxugArI
polycrystalline_noun	bahukristalIya/bahumaNiBIya
polydispersity_noun	bahuparikRepyawA
polyester_noun	poYliestara
polymer_noun	bahulaka/poYlimara
polymerisation_noun	imalSana_bahulakIkaraNa
polymerization_noun	bahulakana/bahulakIkaraNa/bahulakIkaraNa_prakrama
polynomial_noun	bahupaxa
polystyrene_noun	poYlistAirIna
polyurathene_noun	poYliyUreWIna
pore_noun	ranXra
porosity_noun	saranXrawA
porous_noun	saranXrI/saranXra
port_noun	IMXana_xvAra/praxvara/porta
portable_noun	suvAhya
portal_noun	siMha_xvAra/xehalI/portala
posistor_noun	poYjistara
positron_noun	poYjitrAna
possibility_noun	samBAvanA/samBAvyawA
post-graduation_noun	snAwakowwara
posteriad_noun	paScABimuKa
potential_noun	viBava/samBAvyawA
potentiometer_noun	viBavamApI/potenSiyomItara
powder_noun	cUrNa/pAudara
power_noun	Sakwi/UrjA;_GAwa;_kRamawA/sAmarWya
precambrian_noun	kEMbriyana_pUrva
precession_noun	purassaraNa/ayana
precipitation_noun	varRaNa/avakRepaNa
precision_noun	pariSuxXi/pariSuxXawA/pariSuxXa/pariSuxXa_yanwrAvalI
precombustion_noun	pUrvaxahana
precursor_noun	pUrvagAmI/pUrvavarwI
predication_noun	pUrvAnumAna/prAgupwi
predicted_noun	prAgukwa/pUrvAnumAniwa
predictive_noun	prAgukwika
preemphasis_noun	pUrva_prabalana
prefab_noun	pUrvaraciwa/pUrvanirmiwa
preferential_noun	varaNAwmaka
preflight_noun	udAnapUrva
preliminary_noun	prAramBika/AramBika
premix_noun	pUrvamiSra/pUrvamiSriwa
preparation_noun	viracana/nirmiwi/wEyArI
preplastication_noun	pUrvaplAstIkaraNa
presence_noun	upasWiwi/mOjUxagI
presentation_noun	praswuwIkaraNa
preservation_noun	parirakRaNa
pressure_noun	xAba/nipIda
pressurization_noun	nipIdana
prestigious_noun	gOravaSAlI
prestressing_noun	pUrva_prawibalana
presumably_noun	anumAnawa:
prilling_noun	lavana
prima-facie_noun	prawyakRawa:/praWama_xqRtyA
primarily_noun	muKyawa:
primary_noun	Axya/praWama/prAWamika;_muKya;_mUla
primordial_noun	Axya/Axima
prioritisation_noun	prAWamikawA
prism_noun	prijma
pristine_noun	pUrvakAlika;_SuxXa
probability_noun	prAyikawA
probe_noun	anveRaNa/anveRikA/proba
procedure_noun	prakriyA/kAryaviXi
process_noun	bahulakIkaraNa_prakriyA/prakriyA
processing_noun	saMsAXana/prakramaNa
processor_noun	saMsAXiwra
procurement_noun	hAsila/prApaNa/prApwa_karanA
product_noun	guNanaPala;_uwpAxa
production_noun	uwpAxana
profile_noun	paricCexana/proPAila
profit_noun	lABa
progenitor_noun	prajanaka
prograded_noun	pura:kramiwa
programmatic_noun	kAryakramaparaka
programme_noun	kAryakrama;_kramAxeSa/progrAma
programmer_noun	progrAmara/kramAxeSaka
project_noun	pariyojanA;_prakRepaNa
projection_noun	prakRepa
prominence_noun	uwseXa;_sOra_jvAlA
prominent_noun	pramuKa
promote_noun	baDAvA_xenA/prowsAhana_xenA
promotional_noun	prowsAhanI
promotor_noun	varXaka
propagation_noun	saFcaraNa/pracAraNa
propane_noun	propena
propel_noun	noxana_karanA
propellant_noun	noxaka/Tosa_noxaka/viRamAfgI_vikiraNa
propeller_noun	noxiwra
properties_noun	guNaXarma
property_noun	guNaXarma/noxiwra_sPuraNa_guNaXarma
proportional_noun	samAnupAwika
propulsion_noun	noxana
propylene_noun	propilIna
prospect_noun	pUrvekRaNa_(Kanija)
prospector_noun	pUrvekRaka
proton_noun	protoYna
protostar_noun	prAkwArA
protostellar_noun	prAkwArakIya
prototype_noun	Axi_prarUpa
provenance_noun	uxgama_kRewra/janaka_kRewra
province_noun	praxeSa;_kRewra
proximal_noun	nikatasWa/samIpasWa
pseudo-gravitationalfield_noun	guruwvakalpa_kRewra
pseudo-vector_noun	Caxma_saxiSa
pseudo_noun	Caxma/miWyA
pseudoscalar_noun	Caxma_axiSa
psychrometer_noun	vAyuvARpamApI
psychrometry_noun	vAyuvARpamiwi
pulsar_noun	spanxa_wArA/spanxamAna_wArA/palsAra
pulsation_noun	spanxana
pulse_noun	spanxa
pulverizer_noun	peRaNI/KaNdanI
pump_noun	pampa
punch_noun	paFca
purging_noun	pramArjana
purification_noun	nirmalIkaraNa/SuxXIkaraNa
purifier_noun	SoXaka/SuxXaka/nirmalaka
pyro_noun	agnika/uwwApa
pyrogen_noun	pAirojana
pyrojack_noun	uwwApa_jEka
pyrolysis_noun	wApAMSana/wApaapaGatana
pyrometer_noun	uwwApamApI
pyrophoric_noun	sPuliMgI/svawa:_jvalanaSIla/svAgnika
pyrotechnique_noun	agnikI
qpsk-modulation_noun	QPSK-mAdulana
quadrant_noun	cawurWAMSa/vqwwapAxa
quadrupole_noun	cawurXruvI
quality_noun	guNa/guNawA
quantify_noun	mAwrA_nirXAraNa/mAwrIkaraNa
quantity_noun	rASi/parimANa/mAwrA
quantization_noun	kvANtamIkaraNa/iRtavaw_rASikaraNa/kvAntamIkaraNa/xehalI_anwarAla_rASikaraNa/rASikaraNa/kvAntamana
quantized_noun	kvAntiwa
quantizer_noun	rASikAraka/rASikara
quantum_noun	kvAntama
quark_noun	kvArka
quartic_noun	cawurGAwI
quartz_noun	sPatika/kvAtarja
quasar_noun	wArAkalpa/kvAsAra
quasi-precession_noun	ayana_kalpa
quasilinear_noun	rEKikakalpa
quasimode_noun	arXa_viXA/kalpa_viXA
quasinormalcoordinates_noun	sAmAnyavaw_nirxeSAfka
quaternary_noun	cawuRka/cawurWa/cOkadI/kvArtaranarI
quench_noun	Samana
quencher_noun	SAmaka
quenching_noun	Samana/buJAnA
query_noun	pUCawACa
quiescent_noun	SAnwa
quotient_noun	BAgaPala
radar_noun	redAra
radarscope_noun	redAraxarSI
radarslar_)_noun	redAra_(esa.ela.e.Ara)
radial_noun	wrijya/arIya
radian_noun	rediyana
radiance_noun	vikiraNawA
radiating_noun	vikiraNI
radiation_noun	vikiraNa
radiative_noun	vikiraNI
radiatively_noun	vikiraNIya/vikiraNawa:
radical_noun	mUlaka
radioactive_noun	viGatanABika/rediyosakriya/rediyo_XarmI
radioactivity_noun	rediyoEktivawA/rediyoXarmiwA
radiocarbon_noun	rediyokArbana
radiograph_noun	vikiraNa_ciwra/rediyogrAPa
radiography_noun	vikiraNa_ciwraNa
radiometer_noun	vikiraNamApI
radiometric_noun	vikiraNamApIya/vikiraNamiwIya
radionuclide_noun	rediyo_nyUklAida
radiosonde_noun	rediyosonde
radius_noun	wrijyA
radix_noun	mUlAfka
radome_noun	EntenA_gumbaja/redoma
raffinate_noun	rePineta
random_noun	yAxqcCika/aniyamiwa/yAyAvara/reMdama_yAxqcCika_aBigama
randomised_noun	yAxqcCikqwa/yAyAvariwa
range_noun	parAsa/reMja
ranging_noun	parAsana
rapidly_noun	xruwa
raster_noun	rEstara/rAstara
ray_noun	kiraNa/raSmi
re-entry_noun	puna:_praveSa/punarpraveSa
reactant_noun	aBikAraka
reaction_noun	aBikriyA_xara/aBikriyA/prawikriyA
reactive_noun	aBikriyASIla
reactor_noun	riEktara
reader_noun	pATiwra
realignment_noun	punarreKaNa
realistic_noun	yaWArWa_paraka
realm_noun	kRewra/parimaNdala
rear_noun	paSca
rearing_noun	CixravarXana/pariCixraNa/XAvamuxrA
reassessment_noun	punanirXAraNa/punarAkalana
reboiler_noun	punarkvaWiwra
recalibrate_noun	puna:aMSAfkana
recasting_noun	punarDalAI/puna:saFcakana
receiver_noun	aBigrAhI/siMkro-EMTana_aBigrAhI
recently_noun	hAla_meM
reception_noun	aBigrahaNa
recharging_noun	puna:AveSana/punarAveSana
reciprocal_noun	vyuwkrama/anyonya/pArasparika
reciprocatingcompressor_noun	prawyAgAmI_sampIdiwra
recirculation_noun	puna:saFcaraNa
reclamation_noun	suXAra/BUmi_uxXAra
recoil_noun	prawikRepa/prawikRipwa
recombination_noun	punaryojana/punarsaMyojana
reconditioned_noun	navakqwa/xurUswa
reconfiguration_noun	punarvinyAsa
reconnaissance_noun	telivijana_toha
reconnection_noun	punarsambanXana/prekRApAxana
reconstruction_noun	punanirmANa
record_noun	aBileKa/rikArda/afkiwa_karanA/xarja_karanA
recorder_noun	aBileKI
recovery_noun	puna:_prApwi/prawilABa
recrystallisation_noun	puna:_kristalana/puna:_maNiBana
rectifier_noun	xiRtakArI/pariSoXaka
recur_noun	punarAvqwwi
recursion_noun	prawivarwana
reddening_noun	rakwana
redisplay_noun	puna:_praxarSa
reduced_noun	laGukqwa/samAnIwa
reducer_noun	apacAyaka_(paxArWa)/apacAyiwra_(yanwra)
reduction_noun	laGukaraNa/nyUnIkaraNa/Samana_samAnayana/apacayana
redundancy_noun	awirikwawA/awirekawA
redundant_noun	awirikwa/awireka
reef_noun	anwarGUmana/rIPa_(korala)
reemission_noun	puna:uwsarjana/punarUwsarjana
reference_noun	nirxeSa/sanxarBa
refiner_noun	SoXana_kakRa
reflectance_noun	parAvarwakawA
reflection_noun	parAvarwana
reflectivity_noun	parAvarwakawA
reflectometer_noun	parAvarwanamApI
reflex_noun	prawivarwa
reflux_noun	paScavAhI
refraction_noun	apavarwana
refractive_noun	apavarwanI/AvarwanI
refractometer_noun	apavarwanamApI
refractory_noun	uccawApasaha/xurgalanIya/uccawApasaha_aswara
refrigeration_noun	praSIwana
refueling_noun	puna:IMXana_BaraNa/IMXana_punarBaraNa
refurbishment_noun	punarsajjIkaraNa
regeneration_noun	punarjanana/sampoRI_punarniveSana
regime_noun	SAsana/pravqwwi
region_noun	praxeSa/kRewra
register_noun	paFjI/rajistara/paFjIyana
regression_noun	samASrayaNa/paScagamana
regulator_noun	niyAmaka/niyanwraka
reinforced_noun	prabaliwa
reinforcement_noun	prabalIkaraNa/prabalana
rejection_noun	asvIkqwi/bahiRkaraNa
relationship_noun	sambanXa
relative_noun	sApekRika/ApekRika
relatively_noun	ApekRika/apekRawayA
relativistic_noun	sApekRika
relativity_noun	sApekRawA/ApekRikawA
relaxation_noun	viSrAnwi
release_noun	vawaraNa/nirmukwa
released_noun	nirmukwi/mukwa
relevance_noun	susambanXa/mahawva
relevant_noun	prAsafgika
reliability_noun	viSvasanIyawA
reliable_noun	viSvasanIya
relocation_noun	puna:_nirXAraNa/puna:_sWApana
reminiscent_noun	saMsmaraNaSIla/smaraNakArI
remnant_noun	avaSeRa/avaSiRta
renewal_noun	navIkaraNa
repeater_noun	punarAvarwaka
repository_noun	BaNdAraNa
representation_noun	nirUpaNa/praswuwikaraNa
representativeness_noun	prawiniXiwA/nirUpakawA
reprint_noun	punarmuxraNa
reprography_noun	prawiciwraNa
requirement_noun	AvaSyakawA
rescue_noun	bacAva
research_noun	anusanXAna
researcher_noun	anusanXAnakarwA
reservoir_noun	kuNda/hOja/jalASaya/BaNdAra/ASaya/wElASaya
resetting_noun	punarsWApana/punarAfkiwa/puna:_niyojana
residual_noun	avaSiRta/avaSeRa
resilience_noun	prawyAsWawA/prawisWiwiwva
resin_noun	rAla/rejina
resinoid_noun	rejinABa/rejinoYida
resistance_noun	prawiroXa
resistant_noun	prawiroXaka/prawiroXI
resistivity_noun	prawiroXakawA
resolution_noun	viBexana
resonance_noun	anunAxa
resonantly_noun	anunAxI
resource_noun	sAXana/sampaxA
respective_noun	kramika
respectively_noun	kramAnusAra/kramaSa:
response_noun	uwwara/anukriyA/prawivexana
restorer_noun	punarsWApaka
restraint_noun	nigraha
retardation_noun	manxana/avamanxana
retraced_noun	puna:afkiwa/punarAfkiwa/punargamana
retrieval_noun	uxXaraNa/upayojana/puna:_smaraNa
retrieve_noun	puna:_prApwi
retrospective_noun	pUrva_praBAvI
return_noun	prawigamana
revealed_noun	prakatiwa/uxGAtiwa
revealing_noun	prakatana
reversal_noun	uwkramaNa
reverse_noun	uwkrama
review_noun	punarAvalokana
rewrite_noun	punarleKana
ridge_noun	kataka/parvawa_SreNI
rigidity_noun	xqDawA
rigorous_noun	gahana
ring_noun	CallA/valaya
ringing_noun	ninAxa
rinsing_noun	prakRAlana
riometer_noun	riyomItara
rivet_noun	kIlaka/riveta
rivulet_noun	naxikA/nAlA
rocket-ship_noun	roYketa_jahAja_roYkavela_kaTorawA
rocket_noun	roYketa
rocketry_noun	roYketa_vijFAna
roll_noun	lotana/lota
roller_noun	belana
rolling_noun	lotana/lotanI/luDakana/bellana
rosette_noun	rojeta/gulAbavawa
rot_noun	vigalana/sadanA/kRaya
rotameter_noun	vakra_reKAmApI/rotAmApI
rotary_noun	GUrNI
rotation_noun	GUrNana/Avarwana
rotor_noun	GUrNaka/rotara
rougher_noun	rUkRaka
roughing_noun	rUkRawA
roughly_noun	sWUlawa:
roughness_noun	rUkRawA/KuraxarApana/ubada-KAbada
rounding_noun	niRkoNana/nikatana
roundness_noun	golAI
routine_noun	niwyacaryA/nemI/nemakA/lIka
rubber_noun	rabara/rabada
rubbing_noun	niGarRaNa/ragada
run_noun	XAva
rupture_noun	savixAra/savixAraNa
rust_noun	jafga
rydberg_noun	ridabarga
s-band_noun	c_-bEMda
safety_noun	surakRA
salinity_noun	lavaNawA/KArApana
salt_noun	lavaNa/namaka
salting_noun	lavaNana
saltpetre_noun	SorA
salvage_noun	niswAraNa/niswAra
sample_noun	namUnA/prawicayana
sandwich_noun	sEMdavica
satellite-borne_noun	upagraha_vAhiwa
satelloid_noun	laGu_upagraha
satisfy_noun	sanwuRta_honA/sanwuRta_karanA
saturate_noun	sanwqpwa
scab-land_noun	viRama_BUmi
scalar_noun	axiSa/skelara
scald_noun	xravaxAha
scale_noun	mApanI/skela/pEmAnA/mApakrama/Salka/svaragrAma/paladA
scanner_noun	kramavIkRaka
scanning_noun	kramavIkRaNa
scatter_noun	prakIrNana/prakIrNa/biKarAva
scattering_noun	prakIrNana
scatterometer_noun	prakIrNamApI
scene_noun	xqSya
schedule_noun	kAryakrama
scheme_noun	aXiyojanA/yojanA/skIma
schottky_noun	SoYtakI
schrdinger_noun	SrodiMgara
schwinger_noun	SviMgara
scientific_noun	vEjFAnika/vijFAnI
scientist_noun	vijFAnI/vEjFAnika
scintillation_noun	prasPuraNa
scope_noun	kArya_kRewra/viRaya_kRewra
scorpion_noun	vqScika
scrambler_noun	biKeraka/asPutaka
scrambling_noun	biKeranA/PeMtana
scratch_noun	KaroMca;_Kara-Kara_(Xvani)
screening_noun	AvaraNa/sannirIkRaNa
scrutinizing_noun	saMvIkRaNa
seal_noun	sIla/mohara;_banxa_karanA/mohara_lagAnA
searchable_noun	anveRaNIya
secondary_noun	gONa/xviwIya/mAXyamika
section_noun	kAta/paricCexa/sekSana/anuBAga/KaNda
sector_noun	avaKaNda/sektara
sectorally_noun	kRewrIya
sediment_noun	walaCata/avasAxa/gAxa
sedimentary_noun	avasAxa-/gAxI/gAxIya
sedimentation_noun	avasAxana/gAxa_jamanA
sedimentological_noun	avasAxa_vijFAnI/gAxa_vijFAnI
seepage_noun	risana/risAva
segment_noun	KaNda/vicCexa
segmenter_noun	KaNdaka/vicCexaka
segmenting_noun	KaNdana
segregant_noun	visaMyojaka
segregation_noun	visaMyojana/sampqWakana
selectron_noun	selektroYna
selenozone_noun	canxrameKalA
self-impinging_noun	svapraGAwI
self-inductance_noun	svaprerakawva
semantics_noun	safkewArWa_vijFAna/safkewa_vijFAna
semi-ring_noun	valayArXa
semiconductor_noun	arXa-cAlaka
semidiurnal_noun	arXa-xEnika
semimodule_noun	semimAdyUla
semisphere_noun	golArXa
sensing_noun	saMvexana
sensitive_noun	saMvexI/saMvexanaSIla/sugrAhI/sUkRmagrAhI
sensitivity_noun	sugrAhiwA/saMvexanaSIlawA/sUkRmagrAhiwA
sensor_noun	saMvexaka
sepal_noun	bAhyaxala
separation_noun	pqWakkaraNa/pqWakana/pArWakya/anwarAla
separator_noun	pqWakkAriwa/pqWakiwra
sequence_noun	anukrama
sequencer_noun	anukramiwra
sequencing_noun	anukramaNa
sericulture_noun	reSama_uwpAxana
series_noun	SqfKalA/SreNI
servicing_noun	saMvAranA_sarvo_wvaraNamApI
servomotor_noun	sarvo_motara
set-up_noun	DAFcA
set_noun	samuccaya/seta
settling_noun	ni:sAxana/sWiraNa
shade_noun	avakrama/CAyA
shaft_noun	xaNda/XurA/SoYPta
shaker_noun	prakampiwra
shank_noun	maXyAfga;_kanXA/kanXa/skanXa
shape_noun	Akqwi/AkAra/rUpa
shaper_noun	AkAriwra
shaping_noun	rUpaNa
sharpened_noun	wIkRNakqwa/wIkRNiwa/XAraxAra
shear_noun	aparUpaNa/karwana
shed_noun	viBAjaka/pAwana
sheet_noun	cAxara/parawa
shell_noun	parirakRaka/koSa/Kola/AvaraNa/kavaca
shield_noun	DAla/kavaca/koSa
shift_noun	sWAnAnwaraNa/sqwi/sarakana/KisakAnA/pArI
shim_noun	anwarAla_pUraka/pawwI_anwarAla_pUraNa
shipment_noun	nOpreRaNa;_laxAna/preRaNa
shock_noun	praGAwa/XakkA
shrinkage_noun	sikudana/safkucana
shunt_noun	pArSvapaWa/SaNta
shutter_noun	kapAta/Satara
signal_noun	safkewa/signala
signature_noun	pracihna/cihnaka;_haswAkRara
significant_noun	mahawvapUrNa/sArWaka
significantly_noun	muKyawa:
silencer_noun	ravanASaka/ravaSAmaka
silica_noun	silikA
silicate_noun	siliketa
simplex_noun	prasamucya/ekamuKI/ekaXA
simulation_noun	anukaraNa/anukAra/anurUpaNa/sExXAnwika_anurUpaNa
simulator_noun	anukArI/anukAraka
simultaneous_noun	samakAla/samakAlika/eka_sAWa/samakRaNika/yugapaw
simultaneously_noun	eka_sAWa
sine_noun	sAina
sintering_noun	sintarana/nisAxana
sinusoidal_noun	jyAvakrIya
situation_noun	sWiwi/parisWiwi/xaSA
skew_noun	viRamawalIya/teDA
skewing_noun	viRamana
skewness_noun	vERamya
skin_noun	upariswara/wvacA/KAla
skirt_noun	skarta/DalAna_koti
skylab_noun	skAI_lEba
slag_noun	XAwumala
slewing_noun	safGUrNana/xruwa_GUrNana
slicing_noun	slAisa_banAnA/kawalI_banAnA/Sakalana
slit_noun	reKACixra/JirI/slita
slope_noun	DalAna/DAla
sloping_noun	DalavAM
sloshing_noun	AcCalana/Calakana
slurry_noun	pafka/karxama
small_noun	laGu/CotA
smear_noun	Alepa
smearing_noun	Alepana
smectite_noun	smektAita
smoothing_noun	mqxulana/masqNana/cikkaNa
sn-curve_noun	SN-vakra
snap_noun	sanxaMSikA/saMsI/cataka/wadaka/cutakI/snepa
snowmelt_noun	himagalana
soak_noun	sikwana/BigonA
soap_noun	sAbuna
soaping_noun	sAbunana/avaSyAnana
sodic_noun	kRAra/kRArI
software_noun	soYPtaveyara
solder_noun	tAzkA/JAla;_soldara/soldara_karanA/tAzkA_lagAnA/JAlanA/sanXAnaka
soldering_noun	rAzganA/soldarana/tAzkanA/JAlana/tAfkana
solenoid_noun	parinAlikA
solenoidal_noun	parinAlikIya
solid_noun	Tosa/GanAkqwi/piMda
solidification_noun	jamanA/piMdana/jamAnA/piMdIkaraNa
solstice_noun	ayanAnwa/safkrAnwi
solubility_noun	vileyawA/vilayaSIlawA/GulanaSIlawA
solute_noun	vileya
solution_noun	vilayana/Gola/hala/sAXana
solvation_noun	vilAyaka_safkaraNa
solvent_noun	vilAyaka
sonde_noun	sonda
sonic_noun	Xvanika
sonorous_noun	Xvanika
sophisticated_noun	pariRkqwa/gUDa/jatila
sorption_noun	SoRaNa/cURaNa
sort_noun	CAztanA/CaNtAI/CANta
sound_noun	Xvani
sounder_noun	Xvaniwra/parijFApI/XvanIya
sounding_noun	parijFApana;_gamBIrawA_mApana/parijFApana/sArarUpa_roYketa_parijFApana
source_noun	uxgama/srowa
space_noun	anwarikRa/AkASa/anwarAla/xiksWAna/samaRti
spacecraft_noun	anwarikRa_yAna
spacenet_noun	spesaneta
spacer_noun	anwarAlaka/anwarA
spaceship_noun	anwarikRa_yAna
spacing_noun	anwarAla
spatial_noun	xigIya/AkASIya/sWAnika
spatially_noun	xigIya;_xigIyawa:
spatio-kinematic_noun	xikgawika
specialization_noun	viSiRtIkaraNa/viSeRajFawA
specific_noun	ApekRika/viSiRta/viSeRa
specifically_noun	viSiRtawa:
specification_noun	vinirxeSa
specimen_noun	prawixarSa/namUnA
spectacular_noun	Bavya
spectral_noun	varNakramI/spektramI
spectro-reflectometer_noun	spektramI_parAvarwanamApI
spectrograph_noun	spektrogrAPa
spectrometer_noun	spektramamApI/spektromItara/parAbEMganI_spektramamApI
spectrometry_noun	spektramamiwi
spectrophotometry_noun	spektramI_prakASamiwi
spectroscope_noun	spektramaxarSI
spectroscopic_noun	spektroskopika
spectroscopy_noun	spektrama_vijFAna/spektramikI
spectrum_noun	spektrama
speed_noun	cAla/gawi
spheleron_noun	sPeleroYna
sphere_noun	golA/golaka
spherical_noun	golAkAra/golIya
spike_noun	SUla
spin-polarized_noun	pracakraNa_Xruviwa
spin_noun	pracakraNa
spindle_noun	warku/wakuA
spinning_noun	pracakraNa
spiral_noun	sarpila
split-verticalphotograph_noun	UrXva_viBAjana_ciwra
splitting_noun	PAdanA/vipAtana/cIranA/viKaNdiwa_karanA/viBAjiwa_karanA
spoiler_noun	apahAraka
sponge_noun	spaFja
spontaneous_noun	svawa:pravarwiwa/svEcCika/sahaja-_svABAvika/wawkRaNa/wawkRaNika
spool_noun	valanI/PirakI/caraKI
spray_noun	PuhAra/SIkara/CidakAva
spring_noun	kamAnI/spiM_raga
squall_noun	caNdavAwa
squared_noun	ruNdiwa/vargiwa/sPUrwa
squegging_noun	svaroXana
squib_noun	PulaJadI/skviba
stabiliser_noun	sWAyIkArI
stability_noun	sWAyiwva
stabilization_noun	sWirIkaraNa
stack_noun	cattA/stEka
stage_noun	paxa/avasWA/caraNa
staggering_noun	sAnwaraNa/sAnwara_viwaraNa
stagnant_noun	ruxXa/sWira/niScala
stagnation_noun	gawi_SUnyawA/gawi_ruxXawA/niScalawA/avaruxXawA/pragawiroXa
stainless_noun	jafgaroXI/bexAga
stalling_noun	swamBana
standard_noun	mAnaka/pramANiwa
star_noun	wAraka/wArA
static_noun	sWira/sWEwika
statics_noun	sWiwi_vijFAna/sWEwikI
stationary_noun	acara/apragAmI/swabXa/acala/sWAnabaxXa/sWAyI/sWira/sWAvara
stationed_noun	niyukwa/wEnAwa
statistical_noun	sAfKyikIya
statistics_noun	sAfKyikI/Afkade
steel_noun	ispAwa/stIla
steepness_noun	uwpravaNawA/awipravaNawA/KadI_DalAna
steerability_noun	saFcAlanIyawA
steering_noun	saFcAlana/paricAlana
stellar_noun	wArakIya
stepper_noun	sopAnaka
stereo_noun	wrivima/stIriyo
stereotriplet_noun	wrivima_wrik
sterlization_noun	visafkramaNa
stiffness_noun	xurnamyawA
stimulate_noun	uxxIpiwa_karanA
stimulation_noun	uxxIpana
stoichiometric_noun	uciwa_wawvAnupAwI/rasa_samIkaraNamiwIya/stAikiyomiwIya
stoichiometry_noun	rasasamIkaraNamiwi/stAikiyomItrI/uciwa_wawvAnupAwikI
stop_noun	roka
stoppage_noun	virAma
storage_noun	saFcaya
storm_noun	JaFJAvAwa
strain_noun	vikqwi/wAna_vyavahAra
strand_noun	lata/wanwu/rajjuka/strEnda
strategic_noun	yukwipUrNa
strategy_noun	yukwi
stratification_noun	swara_vinyAsa/swaraNa
stratifying_noun	swarIkaraNa
stratigraphically_noun	swarikIya
stratocumulus_noun	swarI_kapAsI
stratopause_noun	samawApa_sImA
stratosphere_noun	samawApamaNdala/stretosPiyara
stratospheric_noun	samawApamaNdalIya
streaking_noun	XArI_padanA
stream_noun	sariwA/XArA/nAlA
strength_noun	sAmarWya/wIvrawA/prabalawA/sAnxraNa/sakriyawA
strengthening_noun	suxqDa_banAnA/xqDIkaraNa/prabalana
stress_noun	prawibala
striation_noun	XArI
strict_noun	xqDa
strictly_noun	xqDawApUrvaka
strictness_noun	xqDawA
string_noun	dorI/wAra/wanwu
stringer_noun	stiM_ragara/nirAkuFcaka/rajjuka
stroboscope_noun	stroboskopa
stroke_noun	AGAwa/praGAwa/stroka
strong_noun	prabala
structure_noun	saMracanA/banAvata
studies_noun	aXyayana
study_noun	aXyayana
styrene_noun	stAirIna
sub-constellation_noun	upawArAmaNdala
sub-scale_noun	upa_pEmAnA/upa_mApanI
sublimation_noun	UrXva_pAwana
subluminal_noun	sabalyUminala/avaprakASa_gawika
submicron_noun	sabamAikroYna
submillimeter_noun	sabamilImItara
subprogramme_noun	upaprogrAma
subroutine_noun	upanemakA/sabarUtIna
subsatellite_noun	anu-upagraha/grahaCAyA
subscribe_noun	aMSaxAna_karanA
subsequently_noun	wawpaScAw
subsoil_noun	avamqxA
subsonic_noun	avaXvAnika
substantial_noun	paryApwa/BarapUra
substantially_noun	paryApwa_mAwrA_meM
substellar_noun	upawArakIya
substrate_noun	avaswara/aXa:swara
substructure_noun	upasaMracanA
subsystem_noun	upawanwra
subtractive_noun	viyojanI/vyavakalanAwmaka
successive_noun	uwwarowwara
suction_noun	cURaNa/cURaka/karRaka
sulphate_noun	poetESiyama_salPeta
sulphur_noun	ganXaka/salPara
sun_noun	sUrya
super-storm_noun	aXiwUPAna/aXiJaFJAvAwa
supersede_noun	aXikramaNa
support_noun	sahAyawA/AXAra/teka
suppression_noun	aXilafGana/xamana
surface_noun	pqRTa/sawahI/bahiswala/sawaha/XarAwala
surfacing_noun	pqRTana
surroundings_noun	pariveSa/Asa-pAsa_kA
surveillance_noun	cOkasI/nigarAnI
survey_noun	sarvekRaNa
susceptibility_noun	cumbakIya_pravqwwi/cumbakIya_sugrAhiwA
suspect_noun	SafkA_karanA;_sanxehAspaxa
suspension_noun	nilambana
sustainable_noun	ciranwana/xIrGakAlika/tikAU
sustainer_noun	poRiwra
swatch_noun	prawixarSa_samUha
swath_noun	pramArja
swelling_noun	sUjana
swept_noun	nawa/mArjiwa
swing_noun	praxola/JUlA
swirl_noun	Bazvara
switch_noun	svica
switching_noun	svicana
symbol_noun	prawIka/cihna/safkewa
symbolic_noun	prawIkAwmaka
symmetric_noun	samamiwa
symmetrical_noun	samamiwIya
symmetricity_noun	samamiwawA
symmetry_noun	samamiwi
symposium_noun	safgoRTI
synchro-capacitor_noun	sinkro_sanXAriwra
synchro-motor_noun	siMkro-motara
synchronisation_noun	samakAlana/wulyakAlana
synchronizer_noun	bita_wulyakAlaka
synchronous_noun	samakAlika/wulyakAlI
synchronousmultiplexing_noun	samakAlI_bahusafkewana
synergetic_noun	yuwi_praBAvI
synergy_noun	sahakriyA
synthesis_noun	saMSleRaNa
synthesized_noun	saMSleRiwa
synthetic_noun	sAMSleRika;_saMSleRI
system_noun	paxXawi/praNAlI/wanwra/xaSamalava_paxXawi
systematic_noun	kramabaxXa/vargIkaraNI/vargIkqwa
t-plus_noun	tI-Xana/tI-plasa
take-up-spool_noun	grAhI_caraKI
tangent_noun	sparSajyA/sparSareKA/tenjeMta
tangential_noun	sparSareKIya/sparSIya
tank_noun	tEMka
tape_noun	PIwA
taper_noun	paccaranumA/kramasUkRmaNa/SuNdI/tepara
technique_)_noun	punarIkRaNa_wakanIka)
technique_noun	wakanIka/praviXi
technology_noun	prOxyogikI/wakanIkI
tele-connection_noun	xUrasaMyojana
telecine_noun	xUra_calaciwra
telecommand_noun	xUrAxeSa
teleconference_noun	xUra_sammelana
teledetection_noun	xUra_saMsUcana
telelimiter_noun	xUra_sImaka
telemeter_noun	xUramApI
telemetering_noun	xUramApana
telemetry_noun	xUramiwi
telephonic_noun	xUraBARika
telescope_noun	xUrabIna/xUraxarSaka/xUraxarSI
telestar_noun	telistAra
teletape_noun	xUratepa
telethermal_noun	xUrawApIya
teletype_noun	xUra_tafkaNa/telitAipa
teletypewriter_noun	telitAiparAitara/xUra_tafkaNa_maSIna
televiewer_noun	telivijana_xarSaka/xUra_xarSaka
television_noun	xUraxarSana/telivijana/xUraxarSana_toha
telex_noun	teleksa
telophase_noun	anwyAvasWA/telAPeja
temperature_noun	wApa/wApamAna
tempered_noun	saMskAriwa
template-matching_noun	teMpleta_sumelana/ParmA_sumelana
temporal_noun	kAlika/SafKa/kAlagawa
tensile_noun	wanana
tension_noun	wanAva
tensor_noun	praxiSa/tensara
tensormatrix_noun	tensara_mEtriksa
tenuous_noun	kaccA/wanu/pawalA
terminal_noun	anwasWa/anwima_Cora/tarminala
terminator_noun	samApiwra
terrace_noun	vexikA/tIlA
terrain_noun	SElapraxeSa/BU-BAga/mExAna/XarApqRTa
terrestrial_noun	sWalIya/pArWiva/BOmika
test_noun	parIkRaNa
testing_noun	parIkRaNa
texture_noun	saMvyUwi/gaTana
thematic_noun	viRayavaswuka
theodolite_noun	WiyodolAita
theoretical_noun	sExXAnwika/sExXAnwika_anukaraNa
theoretically_noun	sixXAnwawa:/sixXAnwa_rUpa_se
theory_noun	sixXAnwa/sparSI_mApAfka_sixXAnwa
thermal_noun	URmIya/wApIya
thermo-vacuum_noun	wApa-nirvAwa
thermo-vacuumchamber_noun	wApa-nirvAwa_kakRa
thermochronological_noun	wApakAlAnukramI/wApakAlakramI
thermocouple_noun	aniSciwawA/wApavExyuw_yugma
thermodynamics_noun	URmAgawikI/URmAgawi_vijFAna
thermogenetic_noun	wApajanaka
thermogram_noun	wApaciwra
thermograph_noun	wApa_ciwraka/wApaleKI
thermography_noun	wApa_ciwraNa
thermometry_noun	wApamiwi
thermopile_noun	wApavExyuw_puFja
thermorelay_noun	wApIya_rile
thermosphere_noun	wApa_maNdala
thickener_noun	sWUlaka/gADaka
thickness_noun	sWUlawA/motAI
thinner_noun	wanukara/viralaka
threshold_noun	xehalI
thresholding_noun	xehalI_sWalAkqwi
throttle_noun	uparoXa
thrust_noun	praNoxa
tide_noun	jvAra/jvAra_BAtA
tideway_noun	jvArapaWa
time_noun	avaXi/kAla/samaya
timer_noun	kAlamApiwra/kAlaxa/tAimara
tintometer_noun	ABAmApI/tintomItara
tipple_noun	rikwana
tiros_noun	tAirasa
titan_noun	tAitana
titling_noun	SIrRakana
titrator_noun	anumApaka/anumApiwra
tolerance_noun	sahyawA/sahana
tool_noun	OjAra
topography_noun	sWalAkqwi
topology_noun	sAMsWiwikI/saMsWiwi-vijFAna
torque_noun	bala_AGUrNa/EMTana/toYrka
torquer_noun	toYrkiwra/bala_AGUrNiwra/bala_AGUrNaka
torsion_noun	EMTana/vimotana/maroda
toughness_noun	sanxqDawA
tower_noun	swamBa/mInAra/tAvara
toxicity_noun	AviRAluwA
trace_noun	anureKa/leSa
tracer_noun	anureKaka
tracking_noun	anuvarwana
traditionally_noun	paramparAgawa
trajectory_noun	prakRepa_paWa/prapaWa
trans-receiver_noun	preRI-grAhI
transducer_noun	trAMsadyUsara
transducing_noun	pArakramI
transfer_noun	sWAnAnwaraNa/anwaraNa
transformation_noun	rUpAnwaraNa/pariNamana
transient_noun	kRaNika/kRaNikA
transit_noun	safkramaNa/trAFjita/asWAI/yAmyowwara/gamana
transition_noun	safkramaNa
translator_noun	anuvAxiwra/anuvAxaka
transmission_noun	saFcaraNa/awulyakAlika_pAragamana/pAragamana/saFcAraNa/preRaNa
transmittance_noun	pAragamyawA
transmitted_noun	prasAriwa/sampreRiwa
transmitter_noun	saFcArI/preRiwra/preRI/siMkro-viBexIpreRiwra
transonic_noun	AXvanika
transparency_noun	pAraxarSiwA/pAraxarSakawA/pAraxarSI_ciwra/trAMsapereMsI/pAraxarSikA
transparent_noun	pAraxarSI
transponder_noun	preRAnukara/trAnsapAnYdara
transposition_noun	pakRAnwaraNa
trap_noun	vipASa/jAla/trEpa
trapping_noun	pragqhaNa/vipASana
treatment_noun	anukUlana/upacAra
tremendous_noun	awiSaya/jabaraxaswa
trial_noun	parIkRaNa
triangulation_noun	wriBujana/wriBujIkaraNa
triassic_noun	wqwIyaka/trAisika
triaxial_noun	wri-akRI
tributary_noun	upanaxI
trigger_noun	vimocaka/pravarwaka/trigara
triggered_noun	vimociwa
trimmer_noun	samAkarwiwra/sUkRma_samaFjaka
trimming_noun	samAkarwana
tripartite_noun	wriBAgI/wripakRIya
tropical_noun	uRNakatibanXIya/sAyana
tropics_noun	ayana_maNdala/uRNakatibanXa
tropopause_noun	kRoBa_sImA
troposphere_noun	kRoBa_maNdala
tropospheric_noun	kRoBamaNdalIya
truss_noun	kEMcI
tube_noun	tyUba/nAla/nalI/nalikA
tubemill_noun	nalikA_mila/nalikA_peRaNI
tuned_noun	anurUpa/samasvariwa
tungsten_noun	tafgastana
tuning_noun	samasvaraNa
tunnel_noun	surafga
tunnelling_noun	surafgana
turbidity_noun	AvilawA
turbine_noun	tarabAina
turbostatic_noun	tarbosWEwika
turbulence_noun	prakRoBa
turbulent_noun	prakRubXa
turning_noun	varwana/moda/KarAxa
turnstile_noun	cakraxvAra
twin-photons_noun	PotoYna_yugma
twin_noun	yamaja/yamala/judavA
twinkling_noun	timatimAnA
twirler_noun	xruwaGrUrNI_xvi
typical_noun	prarUpI/prawirUpI
ultra-cold_noun	awiSIwa
ultracentrifuge_noun	xruwa_apakeMxriwra
ultrafiltration_noun	awisUkRma_nisyanxana/awisUkRma_Piltarana
ultrahigh_noun	awi_ucca_parASravya
ultrasonics_noun	parASravyikI
ultraviolet_noun	parAbEMganI
umbilical_noun	nABIya
umbilicated_noun	nABiyukwa
umbra_noun	axIpwi_keMxra/pracCAyA
umbrella_noun	praCawra/CAwA
unambiguous_noun	spaRta/asanxigXa
unbonded_noun	abanXiwa_wApa_yugma
uncorrelated_noun	asambanXiwa
undercut_noun	avakarwiwa
underpunch_noun	nimna_Cixra
undershoot_noun	avakarRa/avakramaNa
ungraded_noun	akramika
unguided_noun	anirxeSiwa
uniaxial_noun	ekaakRIya/ekAkRa
unidirectionalprocessing_noun	ekaxiSIya_prakramaNa
uniformity_noun	ekasamAnawA/pariveSaka
uninstrumented_noun	ayanwrI
unintelligible_noun	aboXagamya_miSriwa
uninterrupted_noun	lagAwAra/sawawa/beroka/abAXiwa
unit_noun	mAwraka/ekaka/ekAfka/yUnita/ikAI/Ekika
unleash_noun	Kola_xenA
unloaded_noun	aBAriwa
unmagnetized_noun	acumbakiwa
unpacking_noun	vikulana
unsupervised_noun	aparyavekRiwa
unsymmetrical_noun	asamamiwa
unsymmetry_noun	asamamiwi
up-tilt_noun	uparinawi
update_noun	sampUraNa/axyawana
upgradation_noun	unnayana/saMvarXana
upstream_noun	UrXva_pravAha
upwelling_noun	uwsravaNa/uwpravAha
ureilite_noun	yUrIlAita/yUrelAita
vacuum_noun	nirvAwa
valedictory_noun	samApana
valency_noun	saMyojakawA
validate_noun	vEXIkqwa
validation_noun	vEXIkaraNa
validity_noun	vEXawA/mAnyawA
valve_noun	vAlva
valvular_noun	vAlvI
vane_noun	pafKudI/pafKa
vanishing_noun	axqSya_honA/oJala_honA_vARpa/BApa
vapourization_noun	vARpana
vapourizer_noun	vARpiwra
varactor_noun	cara_prawiGAwaka/cara_GAwaka/vErektara
variability_noun	parivarwanaSIlawA
variable_noun	cara/parivarwI
variance_noun	prasaraNa
variation_noun	viBinnawA/parivarwana/vicaraNa
variational_noun	vicaraNI
variety_noun	kisma/upajAwi/upasamaRti/vErAitI
various_noun	viBinna
varying_noun	baxalawe
vast_noun	asIma
vector_noun	saxiSa/vektara/rogavAhaka
vehicle_noun	yAna
velarium_noun	vicCexaka
velocity_noun	vega
venting_noun	nikAsana
venturi_noun	vEncurI
venturimeter_noun	vEncurImApI
verifiable_noun	sawyApanIya
verification_noun	sawyApana/jAFca
verified_noun	sawyApiwa
vertical_noun	UrXvAXara
vessel_noun	pAwra
vibrational_noun	kampanIya
vibrationmeter_noun	kampanamApI
vibrator_noun	kampiwra
videography_noun	vIdiyogrAPI
vidicon_noun	vidikoYna
viewing_noun	xqSyana
vignetting_noun	kramakqSaNa
violation_noun	awikramaNa
virgin_noun	akRawa/aprayukwa
viscoelasticity_noun	SyAnaprawyAsWawA
viscometer_noun	SyAnawAmApI
viscosity_noun	SyAnawA/viskoYsiwA
visible_noun	xqSya
visicorder_noun	xqSyaleKI
vision_noun	xqRti
vistas_noun	AyAma
visualization_noun	mAnasa-prawyakRIkaraNa/ciwrakalpa/cAkRuRIkaraNa
vital_noun	pramuKa
void_noun	SUnyikA/SUnya/KAlIpana/rikwa
volatile_noun	vARpaSIla/suvARpya
volatilization_noun	vARpIkaraNa/vARpana
volcanic_noun	jvAlAmuKIya
volcanism_noun	jvAlAmuKa
volume_noun	Ayawana/parimANa;_prabalawA
volumemeter_noun	AyawanamApI
volumetry_noun	Ayawanamiwi
vortex_noun	Bramila/BaMvara/vorteksa
vorticity_noun	BramilawA
vu-meter_noun	jCa_-mApI
vulcanization_noun	valkanIkaraNa
warhead_noun	XvaMsa_SIrRa/sPotaka_SIrRa
warp_noun	wAnA/teDA
warping_noun	Avalana
washer_noun	prakRAliwra/vASara
washing_noun	prakRAlana
water-body_noun	jala-nikAya/jalakAya/jalASaya
watershed_noun	jalaviBAjaka/jalavAha/jala_safgrahaNa_kRewra/jala_samBara
wave_noun	warafga
wavefunction_noun	warafga_Palana
waveguide_noun	warafga_paWa_nirXAriwra/warafga_paWaka
wavelength_noun	warafgaxErGya
wear_noun	pariGarRaNa/pariXAna/GisAva
weathering_noun	apakRayaNa
web_noun	saFjAla/jAla/kaNTikA
webbing_noun	jAlana
weight_noun	BAra/wOla/vajana;_bAta
weightlessness_noun	BArahInawA
weldability_noun	veldanIyawA/sanXAnIyawA
welding_noun	veldiMga/JAlanA/veldana/JalAI
wettability_noun	klexanIyawA
whispering_noun	PusaPusI
width_noun	cOdAI
wigner_noun	vignEra
wind_noun	vAwa/pavana/lapetanA
winding_noun	kuNdalana/kuNdalI/Avalana
wing_noun	pafKa/pakRa
wipe_noun	poMCanA/mArjana
wire_noun	wAra/wAra_sambanXa_karanA
wiringx_noun	wAra_jodAI/wAra_sambanXana
wobble_noun	dagamagAhata/dagamaga
work_noun	kArya
x-axis_noun	eksa_akRa
x-ray_noun	eksa_kiraNa
x-weight_noun	jr_-wOla
y-nozzle_noun	Y-nojala
yardstick_noun	mApaxaNda
yaw_noun	pArSvavarwana
yawing_noun	pArrSvavarwana
yield_noun	uwpAxa/labXi
yielding_noun	parABavana
z-section_noun	z-KaNda
zeilinger_noun	jAiliMgara
zenith_noun	KamaXya/SirobiMxu
zeolite_noun	jiyolAita
zigzag_noun	teDA_meDA
zirconium_noun	jirkoniyama
zodiac_noun	rASicakra
zonation_noun	kRewrIkaraNa
zone_noun	KaNda/maNdala/kRewra/jona
zonite_noun	xehAMSa
zygosis_noun	jugmajana
