#telecommunication multi word dictionary extracted by Monika Sharma. Formatted by Roja (26-01-2016)	#telecommunication multi word dictionary extracted by Monika Sharma. Formatted by Roja (26-01-2016)
#Changes:: 1) Separated single word and multi words into separate dictionaries	#Changes:: 1) Separated single word and multi words into separate dictionaries
#          2) English words are converted to lower case	#          2) English words are converted to lower case
#          3) Added category as 'noun' by default	#          3) Added category as 'noun' by default
#          4) If last word is not punctuation then treated last word as head	#          4) If last word is not punctuation then treated last word as head
#             or else treated last but one word as head	#             or else treated last but one word as head
#################################################################################	#################################################################################
absolute_block	pUrNa_bloYka#pUrNa_bloYka#noun#2#RM
absolute_block_working	pUrNa_bloYka_kAryacAlana#pUrNa_bloYka_kAryacAlana#noun#3#RM
accomodating_crank	samaFjakakArI_krEMka#samaFjakakArI_krEMka#noun#2#RM
accoustic_horn	Xvanika_wUrya#Xvanika_wUrya#noun#2#RM
adequate_distance	paryApwa_xUrI#paryApwa_xUrI#noun#2#RM
adjusting_apparatus	samaFjaka_upakaraNa#samaFjaka_upakaraNa#noun#2#RM
adjusting_cabin_wire	samaFjaka_kebina_wAra#samaFjaka_kebina_wAra#noun#3#RM
adjusting_crank	samaFjaka_krEMka#samaFjaka_krEMka#noun#2#RM
adjusting_screw	samaFjaka_peMca#samaFjaka_peMca#noun#2#RM
advance_screw	agrima_peMca#agrima_peMca#noun#2#RM
advance_signal	agrima_siganala#agrima_siganala#noun#2#RM
aerial_current	eriyala_kareMta#eriyala_kareMta#noun#2#RM
aerial_frequency_control	vAyavIya_Avqwwi_niyanwraNa#vAyavIya_Avqwwi_niyanwraNa#noun#3#RM
aerial_gain	vAyavIya_lABa#vAyavIya_lABa#noun#2#RM
aerial_radiation_resistance	vAyavIya_vikiraNa_prawiroXaka#vAyavIya_vikiraNa_prawiroXaka#noun#3#RM
aerial_resistance	vAyavIya_prawiroXaka#vAyavIya_prawiroXaka#noun#2#RM
aerial_system	vAyavIya_praNAlI#vAyavIya_praNAlI#noun#2#RM
alternating_current	prawyAvarwI_XArA#prawyAvarwI_XArA#noun#2#RM
amplification_factor	pravarXana_guNaka#pravarXana_guNaka#noun#2#RM
angle_of_polarisation	XruvaNa_koNa#XruvaNa_koNa#noun#3#RM
angle_slide	koNa_pattI#koNa_pattI#noun#2#RM
angle_straight	Qju_koNa#Qju_koNa#noun#2#RM
annode_modulation	enoda_mAdUleSana#enoda_mAdUleSana#noun#2#RM
appartus_foundation	upakaraNa_AXAravalaya#upakaraNa_AXAravalaya#noun#2#RM
approach_control	Agama_niyanwraNa#Agama_niyanwraNa#noun#2#RM
approach_lighting	praveSa_prakASana#praveSa_prakASana#noun#2#RM
approach_locking	pahuFca_pASana#pahuFca_pASana#noun#2#RM
approach_restricted_speed_aspects	pahuFca_gawiprabanXaka_pakRa#pahuFca_gawiprabanXaka_pakRa#noun#4#RM
approach_signal	pahuFca_siganala#pahuFca_siganala#noun#2#RM
approach_signal_lighting	pahuFca_siganala_prakASa#pahuFca_siganala_prakASa#noun#3#RM
approach_track_circuit	rela_Agamana_paripaWa#rela_Agamana_paripaWa#noun#3#RM
approaching_train	AnevAlI_gAdI#AnevAlI_gAdI#noun#2#RM
arm_contact	samparka_BujA#samparka_BujA#noun#2#RM
arm_radial	ArIya_BujA#ArIya_BujA#noun#2#RM
arm_repeater	anucArI_BujA#anucArI_BujA#noun#2#RM
aspect_signal	siganala_pakRa#siganala_pakRa#noun#2#RM
asymmetric_deflection	viRama_vikRepa#viRama_vikRepa#noun#2#RM
audio_range	Sravya_xUrI#Sravya_xUrI#noun#2#RM
auto_surge	svAroha#svAroha#noun#2#RM
automatic_frequency_control	svacAliwa_Avqwwi_niyanwraNa#svacAliwa_Avqwwi_niyanwraNa#noun#3#RM
automatic_gain_control	svacala_lABa_niyanwraNa#svacala_lABa_niyanwraNa#noun#3#RM
automatic_signal	svacala_siganala#svacala_siganala#noun#2#RM
automatic_signalled_territory	svacAliwa_siganala_kRewra#svacAliwa_siganala_kRewra#noun#3#RM
automatic_telephone_exchange	svacAliwa_telIPona_keMxra#svacAliwa_telIPona_keMxra#noun#3#RM
automatic_telephone_system	svacala_telIPona_praNAlI#svacala_telIPona_praNAlI#noun#3#RM
automatic_train_control	svacAliwa_gAdI_niyanwraNa#svacAliwa_gAdI_niyanwraNa#noun#3#RM
automatic_train_stop	svacAliwa_gAdI_roka#svacAliwa_gAdI_roka#noun#3#RM
automatic_tunning_control	svacala_svaraNa_niyanwraNa#svacala_svaraNa_niyanwraNa#noun#3#RM
automatic_warning_system	svacala_cewAvanI_praNAlI#svacala_cewAvanI_praNAlI#noun#3#RM
automotic_block_signalling	svacAliwa_bloYka_siganala_vyavasWA#svacAliwa_bloYka_siganala_vyavasWA#noun#3#RM
auxiliary_light	upasafgI_prakASa#upasafgI_prakASa#noun#2#RM
axle_counter	XurA_gaNaka#XurA_gaNaka#noun#2#RM
back_blinker	piCalA_kOMXaka#piCalA_kOMXaka#noun#2#RM
back_board	piCalA_patta#piCalA_patta#noun#2#RM
back_contact	piCalA_samparka#piCalA_samparka#noun#2#RM
back_light	piCalI_bawwI#piCalI_bawwI#noun#2#RM
back_light_blinder_signal	siganala_ke_ADa_kI_piCalI_bawwI#siganala_ke_ADa_kI_piCalI_bawwI#noun#4#RM
back_light_signal	piCalI_bawwI_siganala#piCalI_bawwI_siganala#noun#3#RM
back_locking	piCalA_parxA#piCalA_parxA#noun#2#RM
balance_lever	sanwulana_lIvara#sanwulana_lIvara#noun#2#RM
balance_weight	sanwulana_BAra#sanwulana_BAra#noun#2#RM
balancing_network	sanwulana_wanwra#sanwulana_wanwra#noun#2#RM
band_switch	bEMda_svica#bEMda_svica#noun#2#RM
banner_flag	roka_pawAkA#roka_pawAkA#noun#2#RM
banner_signal	JaNdA_siganala#JaNdA_siganala#noun#2#RM
banner_type_repeater_signal	pawAkA_prakAra_kA_punarAvarwa_siganala#pawAkA_prakAra_kA_punarAvarwa_siganala#noun#4#RM
beam_light	kiraNa_prakASa#kiraNa_prakASa#noun#2#RM
beat_frequency	spanxana_Avqwi#spanxana_Avqwi#noun#2#RM
beat_frequency_oscillator	vispanxana_Avqwi_xolaka#vispanxana_Avqwi_xolaka#noun#3#RM
bell_code_signal	GaNtI_kUta_siganala#GaNtI_kUta_siganala#noun#3#RM
bell_signal	siganala_GaNtI#siganala_GaNtI#noun#2#RM
block_back	paSca_bloYka#paSca_bloYka#noun#2#RM
block_back_section	paSca_bloYka_sekSana#paSca_bloYka_sekSana#noun#3#RM
block_diagram	bloYka_AreKa#bloYka_AreKa#noun#2#RM
block_forward	agra_bloYka#agra_bloYka#noun#2#RM
block_gear	bloYka_giyara#bloYka_giyara#noun#2#RM
block_indicator	bloYka_safkewa#bloYka_safkewa#noun#2#RM
block_instrument	bloYka_upakaraNa#bloYka_upakaraNa#noun#2#RM
block_instrument_section	bloYka_upakaraNa_sekSana#bloYka_upakaraNa_sekSana#noun#3#RM
block_interlocking_system	bloYka_anwarpASana_praNAlI#bloYka_anwarpASana_praNAlI#noun#3#RM
block_joint	bloYka_joda#bloYka_joda#noun#2#RM
block_post	bloYka_posta#bloYka_posta#noun#2#RM
block_section	bloYkana_sekSana#bloYkana_sekSana#noun#2#RM
block_section_limit_board	bloYka_sekSana_sImA_borda#bloYka_sekSana_sImA_borda#noun#4#RM
block_signal	bloYka_siganala#bloYka_siganala#noun#2#RM
block_station	bloYka_steSana#bloYka_steSana#noun#2#RM
block_switch	bloYka_svica#bloYka_svica#noun#2#RM
block_system	bloYka_praNAlI#bloYka_praNAlI#noun#2#RM
block_working	bloYka_saFcAlana#bloYka_saFcAlana#noun#2#RM
bond_impedence	roka_banXa#roka_banXa#noun#2#RM
bond_plug	plaga_banXa#plaga_banXa#noun#2#RM
bond_resonated_impedence	saspanxiwa_roka_banXa#saspanxiwa_roka_banXa#noun#3#RM
bond_transformer_impedance	trAMsaPoYrmara_roka_banXa#trAMsaPoYrmara_roka_banXa#noun#3#RM
bottom_contact	nicalA_samparka#nicalA_samparka#noun#2#RM
bottom_roller	wala_belana#wala_belana#noun#2#RM
braking_distance_emergency	ApAwa_kAla_meM_breka_lagAne_para_waya_kI_gayI_xUrI#ApAwa_kAla_meM_breka_lagAne_para_waya_kI_gayI_xUrI#noun#3#RM
breaking_distance_service	sAmAnya_wOra_para_breka_lagAne_para_waya_kI_gayI_xUrI#sAmAnya_wOra_para_breka_lagAne_para_waya_kI_gayI_xUrI#noun#3#RM
busy_tone	vyaswa_svara#vyaswa_svara#noun#2#RM
by_pass	upa_mArga/bAhya_paWa#upa_mArga/bAhya_paWa#noun#2#RM
by_pass_condenser	bAhya_paWa_XAriwra#bAhya_paWa_XAriwra#noun#3#RM
cab_signal	kEba_siganala#kEba_siganala#noun#2#RM
calling_on	bulAvA#bulAvA#noun#2#RM
calling_on_signal	bulAvA_siganala#bulAvA_siganala#noun#3#RM
calling_rate	bulAvA_xara#bulAvA_xara#noun#2#RM
carrier_channel	vAhaka_nalI#vAhaka_nalI#noun#2#RM
carrier_equipment	vAhaka_upaskara#vAhaka_upaskara#noun#2#RM
carrier_facility	vAhaka_suviXA#vAhaka_suviXA#noun#2#RM
carrier_frequency	vAhaka_Avqwwi#vAhaka_Avqwwi#noun#2#RM
carrier_telephony	vAhaka_telIPonI#vAhaka_telIPonI#noun#2#RM
carrier_transmission	vAhaka_saFcAraNa/vAhaka_saFcAraNa#vAhaka_saFcAraNa/vAhaka_saFcAraNa#noun#2#RM
carrier_wave	vAhaka_warafga#vAhaka_warafga#noun#2#RM
catch_block	pakada_bloYka#pakada_bloYka#noun#2#RM
catch_handle	pakada_xaswA#pakada_xaswA#noun#2#RM
catch_handle_controller	pakada_xaswA_niyanwraka#pakada_xaswA_niyanwraka#noun#3#RM
catch_handle_interlocking	pakada_xaswA_anwarpASana#pakada_xaswA_anwarpASana#noun#3#RM
catch_point	pakada_biMxu#pakada_biMxu#noun#2#RM
catch_rod	pakada_Cada#pakada_Cada#noun#2#RM
catch_siding	kEca_sAidiMga#kEca_sAidiMga#noun#2#RM
caution_aspect	sawarkawA_pahalU#sawarkawA_pahalU#noun#2#RM
caution_indication	sawarkawA_safkewa#sawarkawA_safkewa#noun#2#RM
caution_notice	sawarkawA_sUcanA#sawarkawA_sUcanA#noun#2#RM
caution_position	sawarkawA_sWiwi#sawarkawA_sWiwi#noun#2#RM
centralised_traffic_control_centre	keMxrIkqwa_yAwAyAwa_niyanwraNa_keMxra#keMxrIkqwa_yAwAyAwa_niyanwraNa_keMxra#noun#4#RM
change_over_contract	baxala_samparka#baxala_samparka#noun#3#RM
check_locking	jAFca_pASana#jAFca_pASana#noun#2#RM
circuit_breakers	paripaWa_viyojaka#paripaWa_viyojaka#noun#2#RM
circuit_controller	paripaWa_niyanwraka#paripaWa_niyanwraka#noun#2#RM
circuit_element	paripaWa_wawva#paripaWa_wawva#noun#2#RM
circuit_interrupter	paripaWa_avaroXaka#paripaWa_avaroXaka#noun#2#RM
circuit_separate_return	pqWaka_vApasI_paripaWa#pqWaka_vApasI_paripaWa#noun#3#RM
circuit_stick	stika_paripaWa#stika_paripaWa#noun#2#RM
classification_of_station	steSanoM_kA_vargIkaraNa#steSanoM_kA_vargIkaraNa#noun#3#RM
closed_circuit_working	banxa_paripaWa_kAryAcAlana#banxa_paripaWa_kAryAcAlana#noun#3#RM
closed_switch	banxa_svica#banxa_svica#noun#2#RM
co_axial_cable	samAkRa_kebala#samAkRa_kebala#noun#3#RM
co_relative	saha_sambanXa#saha_sambanXa#noun#2#RM
coacting_signal	sahakArI_siganala#sahakArI_siganala#noun#2#RM
code_selector	kUta_cayaka#kUta_cayaka#noun#2#RM
coil_loading	BAraNa_kuNdalI#BAraNa_kuNdalI#noun#2#RM
cold_cathode	SIwa_kEWoda#SIwa_kEWoda#noun#2#RM
colour_code	varNa_safkewa#varNa_safkewa#noun#2#RM
colour_light_signal	rafgIna_bawwI_siganala#rafgIna_bawwI_siganala#noun#3#RM
common_departure_signal	sAmUhika_prasWAna_siganala#sAmUhika_prasWAna_siganala#noun#3#RM
composited_circuit	miSriwa_paripaWa#miSriwa_paripaWa#noun#2#RM
conditional_interlocking	saSarwa_anwarpASana/prawibanXiwa_anwarpASana#saSarwa_anwarpASana/prawibanXiwa_anwarpASana#noun#2#RM
conditional_locking	saSarwa_pASana#saSarwa_pASana#noun#2#RM
contact_front	agalA_samparka#agalA_samparka#noun#2#RM
contact_independent	svawanwra_samparka#svawanwra_samparka#noun#2#RM
contact_non_independent	gEra_svawanwra_samparka#gEra_svawanwra_samparka#noun#3#RM
contact_normal	sAmAnya_samparka#sAmAnya_samparka#noun#2#RM
contact_polar	XruvIya_samparka#XruvIya_samparka#noun#2#RM
contact_reverse	vipariwa_samparka#vipariwa_samparka#noun#2#RM
contact_rubbing	GarRaNa_samparka#GarRaNa_samparka#noun#2#RM
control_grid	niyanwraka_grida#niyanwraka_grida#noun#2#RM
controlling_lever	niyanwraNa_lIvara#niyanwraNa_lIvara#noun#2#RM
converging_lines	aBisArI_patariyAM#aBisArI_patariyAM#noun#2#RM
cord_circuit	dorI_paripaWa#dorI_paripaWa#noun#2#RM
cord_dial	dAyala_dorI#dAyala_dorI#noun#2#RM
cord_receiver	aBigrAhi_dorI#aBigrAhi_dorI#noun#2#RM
cord_wiper	vAIpara_dorI#vAIpara_dorI#noun#2#RM
counter_weight	prawi_BAra#prawi_BAra#noun#2#RM
counter_weight_semaphore	prawi_BAra_semAPora#prawi_BAra_semAPora#noun#3#RM
countor_signal	prawi_siganala#prawi_siganala#noun#2#RM
crank_adjustable	samaFjanIya_krEMka#samaFjanIya_krEMka#noun#2#RM
crank_adjustable_straight_arm	samaFjanIya_sIXa_BujA_krEMka#samaFjanIya_sIXa_BujA_krEMka#noun#4#RM
cross_bar	krAsa_bAra#krAsa_bAra#noun#2#RM
cross_bond_signalling	katavA_banXa_(siganala)#katavA_banXa_(siganala)#noun#3#RM
cross_connection	krAsa_saMyojana#krAsa_saMyojana#noun#2#RM
cross_modulation	krAsa_aXimiSraNa#krAsa_aXimiSraNa#noun#2#RM
cross_over	krAsa_ovara/pAragAmI#krAsa_ovara/pAragAmI#noun#2#RM
cross_protection	prawi_saMrakRaNa#prawi_saMrakRaNa#noun#2#RM
cross_sectional_area	anuprasWa_kAta_kRewraPala#anuprasWa_kAta_kRewraPala#noun#3#RM
cross_talk	miSriwa_vArwA#miSriwa_vArwA#noun#2#RM
cross_talk_attenuation	miSriwa_vArwA_wanukaraNa#miSriwa_vArwA_wanukaraNa#noun#3#RM
cross_talk_volume	miSriwa_vArwA_pariNAma#miSriwa_vArwA_pariNAma#noun#3#RM
crossing_station	krAsiMga_steSana#krAsiMga_steSana#noun#2#RM
crystal_detector	sPatika_paricAyaka#sPatika_paricAyaka#noun#2#RM
crystal_oscillator_drive	sPatika_xolaka_cAlaka#sPatika_xolaka_cAlaka#noun#3#RM
current_feed_back	XArA_prawipuRti#XArA_prawipuRti#noun#3#RM
current_stray	vipaWiwa_XArA#vipaWiwa_XArA#noun#2#RM
cut_off	vicCexa#vicCexa#noun#2#RM
cut_off_bias	vicCexa_bAyasa#vicCexa_bAyasa#noun#3#RM
cut_off_frequency	vicCexa_Avqwwi#vicCexa_Avqwwi#noun#3#RM
cut_station_track_circuit	vicCinnaRti_steSana_rela_paripaWa#vicCinnaRti_steSana_rela_paripaWa#noun#4#RM
damping_plate	avamanxana_pleta#avamanxana_pleta#noun#2#RM
danger_position	Kaware_kI_sWiwi#Kaware_kI_sWiwi#noun#2#RM
data_logger	dAtA_lAgara#dAtA_lAgara#noun#2#RM
dc_component	xiRta_XArA_Gataka#xiRta_XArA_Gataka#noun#2#RM
de_energise	UrjA_hIna_karanA#UrjA_hIna_karanA#noun#2#RM
dead_end	anwima_Cora#anwima_Cora#noun#2#RM
dead_section	niRkriya_sekSana#niRkriya_sekSana#noun#2#RM
deflecting_bar	vikRepa_Cada#vikRepa_Cada#noun#2#RM
deflection_de_focussing	vikRepI_vikeMxrIkaraNa#vikRepI_vikeMxrIkaraNa#noun#3#RM
deflector_coil	vikRepI_koYyala#vikRepI_koYyala#noun#2#RM
deflector_plate	vikRepI_pattI#vikRepI_pattI#noun#2#RM
delay_equaliser	vilamba_samakArI#vilamba_samakArI#noun#2#RM
demand_service_trunk_circuit	mAfga_sevA_trafka_paripaWa#mAfga_sevA_trafka_paripaWa#noun#4#RM
derailing_switch	direliMga_svica#direliMga_svica#noun#2#RM
dew_point	osAfka#osAfka#noun#2#RM
digital_microwave	dijitala_sUkRma_warafga#dijitala_sUkRma_warafga#noun#2#RM
dipole_aerial	xviXruva_vAyavIya#xviXruva_vAyavIya#noun#2#RM
direct_current	xiRta_XArA#xiRta_XArA#noun#2#RM
direct_impedance	prawyakRa_avabAXiwA#prawyakRa_avabAXiwA#noun#2#RM
distant_signal	xUra_siganala#xUra_siganala#noun#2#RM
diverging_junction	vigamana_jafkSana#vigamana_jafkSana#noun#2#RM
diverging_lines	apasArI_patariyAM#apasArI_patariyAM#noun#2#RM
diverging_route	apasArI_mArga#apasArI_mArga#noun#2#RM
double_band_transmission	xo_bEMda_vAlA_prasAraNa#xo_bEMda_vAlA_prasAraNa#noun#3#RM
double_line_block_instrument	xoharI_lAina_bloYka_upakaraNa#xoharI_lAina_bloYka_upakaraNa#noun#4#RM
driving_point_impedance	cAlana_biMxu_avabAXiwA#cAlana_biMxu_avabAXiwA#noun#3#RM
dwarf_shunting	bOnA_SaNtiMga#bOnA_SaNtiMga#noun#2#RM
echo_suppressor	gUFja_xamanakArI#gUFja_xamanakArI#noun#2#RM
electrial_communication_instrument	vixyuwa_saFcAra_upakaraNa#vixyuwa_saFcAra_upakaraNa#noun#3#RM
electric_interlocking	vixyuwa_anwarpASana#vixyuwa_anwarpASana#noun#2#RM
electric_lever_lock	vixyuwa_lIvara_wAlA#vixyuwa_lIvara_wAlA#noun#3#RM
electric_screen	vixyuwa_parxA#vixyuwa_parxA#noun#2#RM
electric_speaking_instrument	vixyuwa_Xvani_upakaraNa#vixyuwa_Xvani_upakaraNa#noun#3#RM
electric_token_instrument	vixyuwa_tokana_upakaraNa#vixyuwa_tokana_upakaraNa#noun#3#RM
electrical_block_instrument	vixyuwa_bloYka_upakaraNa#vixyuwa_bloYka_upakaraNa#noun#3#RM
electrical_conductor	vixyuwa_saMvAhaka#vixyuwa_saMvAhaka#noun#2#RM
electrical_control	vixyuwa_niyanwraNa#vixyuwa_niyanwraNa#noun#2#RM
electrical_cross_connection	vixyuwa_kroYsa_kanekSana#vixyuwa_kroYsa_kanekSana#noun#3#RM
electrical_equipment	vixyuwa_upaskara#vixyuwa_upaskara#noun#2#RM
electrical_plunger	vixyuwa_plaFjara#vixyuwa_plaFjara#noun#2#RM
electrical_signalling	vixyuwa_siganala_vyavasWA#vixyuwa_siganala_vyavasWA#noun#2#RM
electro_gas_signal	vixyuwa_gEsa_siganala#vixyuwa_gEsa_siganala#noun#3#RM
electro_magnetic_screen	vixyuwa_cumbakIya_parxA#vixyuwa_cumbakIya_parxA#noun#3#RM
electro_mechanical_drive	vixyuwa_yAnwrika_cAlana#vixyuwa_yAnwrika_cAlana#noun#3#RM
electro_mechanical_inter_locking_frame	vixyuwa_yAnwrika_anwarpASana_DAFcA#vixyuwa_yAnwrika_anwarpASana_DAFcA#noun#5#RM
electro_pneumatic_valve	vixyuwa_vAyavIya_vAlva#vixyuwa_vAyavIya_vAlva#noun#3#RM
electronic_exchange	ilEktrAnika_eksaceMja#ilEktrAnika_eksaceMja#noun#2#RM
emergency_control_circuit	ApAwa_niyanwraNa_paripaWa#ApAwa_niyanwraNa_paripaWa#noun#3#RM
emergency_release	ApAwa_nirmukwi#ApAwa_nirmukwi#noun#2#RM
exchange_area	keMxra_kRewra#keMxra_kRewra#noun#2#RM
exchange_plant	keMxra_saMyanwra#keMxra_saMyanwra#noun#2#RM
exciting_current	uwwejaka_XArA#uwwejaka_XArA#noun#2#RM
expected_train	prawyASiwa_gAdI#prawyASiwa_gAdI#noun#2#RM
extraction_of_token	tokana_nikAlanA#tokana_nikAlanA#noun#3#RM
facing_point	sammuKa_kANtA#sammuKa_kANtA#noun#2#RM
facing_point_lock	sammuKa_kANtA_wAlA#sammuKa_kANtA_wAlA#noun#3#RM
false_indication	JUTA_safkewa#JUTA_safkewa#noun#2#RM
fault_localisation	xoRa_sWAna_niScayana#xoRa_sWAna_niScayana#noun#2#RM
feed_end	BaraNa_Cora#BaraNa_Cora#noun#2#RM
feed_set	BaraNa_seta#BaraNa_seta#noun#2#RM
filament_current	wanwu_XArA#wanwu_XArA#noun#2#RM
filament_voltage	wanwu_voltawA#wanwu_voltawA#noun#2#RM
filter_assembly	CannI_samuccaya#CannI_samuccaya#noun#2#RM
final_selector	anwima_saMvaraka#anwima_saMvaraka#noun#2#RM
first_stop_signal	praWama_roka_siganala#praWama_roka_siganala#noun#3#RM
fixed_signal	sWAvara_siganala#sWAvara_siganala#noun#2#RM
flag_type_indicator	JaNdInumA_safkewaka#JaNdInumA_safkewaka#noun#3#RM
flap_indicator	pallA_safkewaka#pallA_safkewaka#noun#2#RM
flare_signal	Pleyara_siganala#Pleyara_siganala#noun#2#RM
flasher_light_signal	kOMXaka_bawwI_siganala#kOMXaka_bawwI_siganala#noun#3#RM
flasher_relay	kOMXaka_rile#kOMXaka_rile#noun#2#RM
flood_lit_disc	xIpwa_cakarI#xIpwa_cakarI#noun#3#RM
fly_back	prawyAvarwana#prawyAvarwana#noun#2#RM
focal_point	nABikA_biMxu#nABikA_biMxu#noun#2#RM
focusing_device	PokasI_sAXana#PokasI_sAXana#noun#2#RM
fog_repeater_signal	koharA_punarAvarwaka_siganala#koharA_punarAvarwaka_siganala#noun#3#RM
forced_oscillation	praNoxiwa_xolana#praNoxiwa_xolana#noun#2#RM
fouling_bar	ullafGana_roXI#ullafGana_roXI#noun#2#RM
fouling_mark	ullafGana_cihma#ullafGana_cihma#noun#2#RM
fouling_point	ullafGana_sWala#ullafGana_sWala#noun#2#RM
four_aspects_colour_light_signal	cAra_pakRIya_rafgIna_bawwI_siganala#cAra_pakRIya_rafgIna_bawwI_siganala#noun#5#RM
four_wire_amplifier	cAra_wAra_vAlA_eMplIPAyara#cAra_wAra_vAlA_eMplIPAyara#noun#3#RM
free_oscillation	nirbAXa_xolana#nirbAXa_xolana#noun#2#RM
frequency_deviation	Avqwwi_vicalana#Avqwwi_vicalana#noun#2#RM
frequency_divider	Avqwwi_viBAjaka#Avqwwi_viBAjaka#noun#2#RM
frequency_monitor	Avqwwi_anuSrAvaka#Avqwwi_anuSrAvaka#noun#2#RM
frequency_multiplier	Avqwwi_guNaka#Avqwwi_guNaka#noun#2#RM
frequency_swing	Avqwwi_JUlA#Avqwwi_JUlA#noun#2#RM
front_contact	agalA_samparka#agalA_samparka#noun#2#RM
fundamental_frequency	mUla_Avqwwi#mUla_Avqwwi#noun#2#RM
fusible_flug	galanIya_plaga#galanIya_plaga#noun#2#RM
gas_current	gEsa_XArA#gEsa_XArA#noun#2#RM
gate_lamp_swivelling_apparatus	GUmanevAlA_geta_lEMpa_upakaraNa#GUmanevAlA_geta_lEMpa_upakaraNa#noun#4#RM
gate_lock	PAtaka_wAlA#PAtaka_wAlA#noun#2#RM
gate_stop	roka_PAtaka#roka_PAtaka#noun#2#RM
gate_target	geta_tArgeta#geta_tArgeta#noun#2#RM
gate_wheel	PAtaka_pahiyA#PAtaka_pahiyA#noun#2#RM
ground_colour_light_warning_signal	BUwala_rafgIna_bawwI_cewAvanI_siganala#BUwala_rafgIna_bawwI_cewAvanI_siganala#noun#5#RM
ground_frame	nicalA_DAFcA#nicalA_DAFcA#noun#2#RM
ground_track_lock	BUwala_patarI_wAlA#BUwala_patarI_wAlA#noun#3#RM
group_velocity	samUha_vega#samUha_vega#noun#2#RM
guage_plate	AmAna_pattI#AmAna_pattI#noun#2#RM
guard_band	rakRA_pattI#rakRA_pattI#noun#2#RM
guide_gap	niyAmaka_anwarAla#niyAmaka_anwarAla#noun#2#RM
guide_roller_assembly	belanaxala_niyAmaka#belanaxala_niyAmaka#noun#3#RM
guy_wire_or_rod	sahAyaka_wAra_yA_Cada#sahAyaka_wAra_yA_Cada#noun#4#RM
half_toric_sector	arXa_tArika_KaNda#arXa_tArika_KaNda#noun#3#RM
half_wave_dipole	arXa_warafga_xviXruva#arXa_warafga_xviXruva#noun#3#RM
half_wave_rectifier_circuit	arXa_warafga_eka_xiSakArI_paripaWa#arXa_warafga_eka_xiSakArI_paripaWa#noun#4#RM
hand_plunger_key_lock	haswacApI_wAlA#haswacApI_wAlA#noun#4#RM
hand_test_telephone	xaswI_jAFca_tolIPona#xaswI_jAFca_tolIPona#noun#3#RM
head_light	pramuKa_bawwI#pramuKa_bawwI#noun#2#RM
head_phone	heda_Pona#heda_Pona#noun#2#RM
heat_coil	uRmA_kuNdalI#uRmA_kuNdalI#noun#2#RM
heavy_duty_contact	saGana_samparka#saGana_samparka#noun#3#RM
height_guage	UzcAI_mApI#UzcAI_mApI#noun#2#RM
high_pass_filter	ucca_nikAsa_Piltara#ucca_nikAsa_Piltara#noun#3#RM
high_power_modulation	ucca_Sakwi_mAdulana#ucca_Sakwi_mAdulana#noun#3#RM
hold_off_device	nivAraNa_yukwi#nivAraNa_yukwi#noun#3#RM
hold_off_mechanism	nivAraNa_yanwrikA#nivAraNa_yanwrikA#noun#3#RM
holding_time	XAraNa_samaya#XAraNa_samaya#noun#2#RM
home_signal	nikata_siganala#nikata_siganala#noun#2#RM
horizontal_polarised_wave	kREwija_XruvIya_warafga#kREwija_XruvIya_warafga#noun#3#RM
hybrid_coil	safkara_kuNdalI#safkara_kuNdalI#noun#2#RM
hysteresis_factor	histeresisa_PEktara#histeresisa_PEktara#noun#2#RM
image_transfer	prawibiMba_sWAnAnwara#prawibiMba_sWAnAnwara#noun#2#RM
impairing_visibility	aspaRta_xqSyawA#aspaRta_xqSyawA#noun#2#RM
impulse_circuit	Avega_paripaWa#Avega_paripaWa#noun#2#RM
impulse_frequency	Avega_Avqwwi#Avega_Avqwwi#noun#2#RM
impulse_period	Avega_kAla#Avega_kAla#noun#2#RM
impulse_ratio	Avega_anupAwa#Avega_anupAwa#noun#2#RM
impulsing_signal	AvegIya_siganala#AvegIya_siganala#noun#2#RM
impulsive_action	Avega_kriyA#Avega_kriyA#noun#2#RM
incoming_token	Avaka_tokana#Avaka_tokana#noun#2#RM
indication_contact	safkewa_samparka#safkewa_samparka#noun#2#RM
indication_dynamic	safkewa_gawi#safkewa_gawi#noun#2#RM
indication_lock	safkewa_pASa#safkewa_pASa#noun#2#RM
indicator_lever	safkewaka_lIvara#safkewaka_lIvara#noun#2#RM
indicator_needle_type	sUI_nUmA_safkewa#sUI_nUmA_safkewa#noun#3#RM
indicator_slot	slAta_safkewa#slAta_safkewa#noun#2#RM
indirect_locking	aprawyakRa_pASana#aprawyakRa_pASana#noun#2#RM
induction_coil	preraNa_kuNdalI#preraNa_kuNdalI#noun#2#RM
inner_distance_signal	BIwarI_xUrI_siganala#BIwarI_xUrI_siganala#noun#3#RM
input_capacitance	anwargAmI_XAriwA#anwargAmI_XAriwA#noun#2#RM
insertion_gain	sinnaveSa_lABa#sinnaveSa_lABa#noun#2#RM
insertion_loss	sinnaveSa_hAni#sinnaveSa_hAni#noun#2#RM
insulated_plate	avaroXaka_pleta#avaroXaka_pleta#noun#2#RM
insulated_stretchers	vixyuwa_roXI_strecara#vixyuwa_roXI_strecara#noun#2#RM
insulated_wire	vixyuwa_roXI_wAra#vixyuwa_roXI_wAra#noun#2#RM
integrated_telephone	samAkaliwa_telIPona#samAkaliwa_telIPona#noun#2#RM
inter_communication	anwara_saFcAra#anwara_saFcAra#noun#2#RM
inter_dialling	anwara_dAyalana#anwara_dAyalana#noun#2#RM
inter_wire	anwara_wAra#anwara_wAra#noun#2#RM
interference_zone	bAXA_kRewra#bAXA_kRewra#noun#2#RM
interlocked_relay	anwarpASiwa_rile#anwarpASiwa_rile#noun#2#RM
interlocked_scanning	anwara_granWiwa_aMSekRaNa#anwara_granWiwa_aMSekRaNa#noun#2#RM
interlocking_apparatus	anwarpASana_upakaraNa#anwarpASana_upakaraNa#noun#2#RM
interlocking_block_instrument	anwarpASana_bloYka_upakaraNa#anwarpASana_bloYka_upakaraNa#noun#3#RM
interlocking_chart	anwarpASana_cArta#anwarpASana_cArta#noun#2#RM
interlocking_frame	aMrwapASana_DAFcA#aMrwapASana_DAFcA#noun#2#RM
interlocking_frame_quadrant	anwarpASana_DAFcA_kvAdreMta#anwarpASana_DAFcA_kvAdreMta#noun#3#RM
interlocking_installation	anwarpASana_saMsWApana#anwarpASana_saMsWApana#noun#2#RM
interlocking_layout	anwarpASana_vinyAsa#anwarpASana_vinyAsa#noun#2#RM
interlocking_relay_system	anwarpASana_irale_praNAlI#anwarpASana_irale_praNAlI#noun#3#RM
interlocking_rotation	anwarpASana_GUrNana#anwarpASana_GUrNana#noun#2#RM
interlocking_sequential	anukramika_anwarpASana#anukramika_anwarpASana#noun#2#RM
intermediate_block_post	maGyavarwI_bloYka_posta#maGyavarwI_bloYka_posta#noun#3#RM
intermediate_block_signalling	maXyavarwI_bloYka_siganala_vyavasWA#maXyavarwI_bloYka_siganala_vyavasWA#noun#3#RM
intermediate_frequency	maXyavarwI_Avqwwi#maXyavarwI_Avqwwi#noun#2#RM
intermediate_quadrant	maXyavarwI_kvAdreMta#maXyavarwI_kvAdreMta#noun#2#RM
intermediate_starter_signal	maXyavarwI_prasWAna_siganala#maXyavarwI_prasWAna_siganala#noun#3#RM
intermodulation_distortion	anwaraXimiSraNa_vikqwiRti#anwaraXimiSraNa_vikqwiRti#noun#2#RM
interrupted_ringing	anwaroXiwa_vAxana#anwaroXiwa_vAxana#noun#2#RM
ionisation_current	AyanIkaraNa_XArA#AyanIkaraNa_XArA#noun#2#RM
ionisation_potential	AyanIkaraNa_viBava#AyanIkaraNa_viBava#noun#2#RM
ionospheric_ray	AyanamaNdlIya_kiraNa#AyanamaNdlIya_kiraNa#noun#2#RM
ionospheric_wave	AyanamaNdalIya_warafga#AyanamaNdalIya_warafga#noun#2#RM
iron_clad_switch	lohAnI_svica#lohAnI_svica#noun#3#RM
isolating_switch	pqWakkArI_svica#pqWakkArI_svica#noun#2#RM
jack_spring_combination	jEka_kviMspraga_samUha#jEka_kviMspraga_samUha#noun#3#RM
jaw_plunger	jabadA_dAta#jabadA_dAta#noun#2#RM
jaw_screw	jabadA_peMca#jabadA_peMca#noun#2#RM
jiont_slotted	KAFcexAra_joda#KAFcexAra_joda#noun#2#RM
joint_eye	AzKa_joda#AzKa_joda#noun#2#RM
joint_flush	sapAta_joda#sapAta_joda#noun#2#RM
joint_long	lambA_joda#lambA_joda#noun#2#RM
joint_lug	laga_joda#laga_joda#noun#2#RM
joint_off_set	mudA_joda#mudA_joda#noun#3#RM
joint_screw	peMcaxAra_joda#peMcaxAra_joda#noun#2#RM
joint_solid	Tosa_joda#Tosa_joda#noun#2#RM
joint_wide	cOdA_joda#cOdA_joda#noun#2#RM
jumper_wire	jampara_wAra#jampara_wAra#noun#2#RM
junction_box	jafkSana_baksa#jafkSana_baksa#noun#2#RM
junction_indicator	jafkSana_safkewaka#jafkSana_safkewaka#noun#2#RM
key_lever	cAbI_kala#cAbI_kala#noun#2#RM
key_listening	SravaNa_cAbI#SravaNa_cAbI#noun#2#RM
key_lock	wAlA_cAbI#wAlA_cAbI#noun#2#RM
key_lock_extension	wAlA_cAbI_viswAra#wAlA_cAbI_viswAra#noun#3#RM
key_morse	morsa_kuFjI#morsa_kuFjI#noun#2#RM
key_shelf	kuFjI_SelPa#kuFjI_SelPa#noun#2#RM
key_transmitter	preRaka_cAbI#preRaka_cAbI#noun#2#RM
keyless_ringing	svawaH_raNana#svawaH_raNana#noun#2#RM
king_lever	muKya_lIvara#muKya_lIvara#noun#2#RM
ladder_ring	sIDI_valaya#sIDI_valaya#noun#2#RM
lamp_expander	bawwI_viswAraka#bawwI_viswAraka#noun#2#RM
lamp_jack	jEka_bawwI#jEka_bawwI#noun#2#RM
lamp_long_burning	xIrGa_jvalana#xIrGa_jvalana#noun#3#RM
lamp_signal	siganala_bawwI#siganala_bawwI#noun#2#RM
last_stop_signal	anwima_roka_siganala#anwima_roka_siganala#noun#3#RM
last_subscriber_release	anwima_aBixAwA_mocana#anwima_aBixAwA_mocana#noun#3#RM
last_vehicle	anwima_vAhana#anwima_vAhana#noun#2#RM
lattice_network	gavAkRa_jAla#gavAkRa_jAla#noun#2#RM
left_hand_quadrant	bAyAM_bAjU_kvAdreMta#bAyAM_bAjU_kvAdreMta#noun#3#RM
lens_deflecting	visWAna_lEMsa#visWAna_lEMsa#noun#2#RM
level_crossing	samapAra#samapAra#noun#2#RM
level_crossing_alarm	samapAra_cewAvanI#samapAra_cewAvanI#noun#3#RM
level_crossing_gate	samapAra_PAtaka#samapAra_PAtaka#noun#3#RM
lever_bolt_lock	lIvara_bolta_wAlA#lIvara_bolta_wAlA#noun#3#RM
lever_bridge_bolt	lIvara_brija_bolta#lIvara_brija_bolta#noun#3#RM
lever_circuit_controller	paripaWa_niyanwraka_lIvara#paripaWa_niyanwraka_lIvara#noun#3#RM
lever_clearance_bar	nirXAriwa_Cada_lIvara#nirXAriwa_Cada_lIvara#noun#3#RM
lever_collar	lIvara_koYlara#lIvara_koYlara#noun#2#RM
lever_cotter	lIvara_PannI/koYtara#lIvara_PannI/koYtara#noun#2#RM
lever_cover	lIvara_Dakkana#lIvara_Dakkana#noun#2#RM
lever_crossing_barrier	samapAra_nAkA#samapAra_nAkA#noun#3#RM
lever_crossing_bell	samapAra_GaNtI#samapAra_GaNtI#noun#3#RM
lever_detonator_placer	detonetara_plesara_lIvara#detonetara_plesara_lIvara#noun#3#RM
lever_directional	xiSAparaka_lIvara#xiSAparaka_lIvara#noun#2#RM
lever_disengager	viyojaka_lIvara#viyojaka_lIvara#noun#2#RM
lever_facing_point_lock	sammuKa_kANtA_pASana_lIvara#sammuKa_kANtA_pASana_lIvara#noun#4#RM
lever_handle	lIvara_mUTa#lIvara_mUTa#noun#2#RM
lever_point	pAMita_lIvara#pAMita_lIvara#noun#2#RM
lever_route	mArga_lIvara#mArga_lIvara#noun#2#RM
lever_route_indicator	mArga_safkewaka_lIvara#mArga_safkewaka_lIvara#noun#3#RM
lever_shoe	nAla_lIvara#nAla_lIvara#noun#2#RM
lever_side	pArSva_lIvara#pArSva_lIvara#noun#2#RM
lever_spacing	anwaraka_lIvara#anwaraka_lIvara#noun#2#RM
lever_spare	awiriwka_lIvara#awiriwka_lIvara#noun#2#RM
lever_tail	lIvara_tela#lIvara_tela#noun#2#RM
lifting_barrier	uTAna_PAtaka#uTAna_PAtaka#noun#2#RM
light_deflecting_unit	prakASa_vicAlaka_ikAI#prakASa_vicAlaka_ikAI#noun#3#RM
light_proving_relay	prakASa_pramANana_rile#prakASa_pramANana_rile#noun#3#RM
light_repeater	prakASa_punarArvawaka#prakASa_punarArvawaka#noun#2#RM
light_signal_position	bawwI_sWiwi_siganala#bawwI_sWiwi_siganala#noun#3#RM
lightning_discharger	wadiwa_kRepI#wadiwa_kRepI#noun#2#RM
lightning_protector	wadiwa_rakRaka#wadiwa_rakRaka#noun#2#RM
limit_of_speed	gawi_sImA#gawi_sImA#noun#3#RM
line_blocked	avaruxXa_lAina#avaruxXa_lAina#noun#2#RM
line_circuit	lAina_paripaWa#lAina_paripaWa#noun#2#RM
line_clear	lAina_kliyara#lAina_kliyara#noun#2#RM
line_closed	lAina_banxa#lAina_banxa#noun#2#RM
line_current	lAina_kareMta#lAina_kareMta#noun#2#RM
line_fault	lAina_xoRa#lAina_xoRa#noun#2#RM
line_relay	lAina_rile#lAina_rile#noun#2#RM
linear_detection	anureKa_paricAyana#anureKa_paricAyana#noun#2#RM
link_split	viBAjiwa_kadI#viBAjiwa_kadI#noun#2#RM
local_battery	sWAnIya_bEtarI#sWAnIya_bEtarI#noun#2#RM
location_of_signal	siganala_kI_sWiwi#siganala_kI_sWiwi#noun#3#RM
lock_bar	pASana_Cada#pASana_Cada#noun#2#RM
lock_bar_clip	pASana_Cada_klipa#pASana_Cada_klipa#noun#3#RM
lock_coil	pASana_kuNdalI#pASana_kuNdalI#noun#2#RM
lock_indicator	pASana_safkewaka#pASana_safkewaka#noun#2#RM
lock_rod	pASana_Cada#pASana_Cada#noun#2#RM
locking_box	pASana_baksa#pASana_baksa#noun#2#RM
locking_box_bracket	pASana_baksa_brEkata#pASana_baksa_brEkata#noun#3#RM
locking_dead	niRkriya_pASana#niRkriya_pASana#noun#2#RM
locking_proving_contact	pASana_pramANana_samparka#pASana_pramANana_samparka#noun#3#RM
loop_aerial	vAyavIya_lUpa#vAyavIya_lUpa#noun#2#RM
loop_dialling	lUpa_dAyalana#lUpa_dAyalana#noun#2#RM
low_pass_filter	nimna_nikAsa_Piltara#nimna_nikAsa_Piltara#noun#3#RM
low_power_modulation	nimna_Sakwi_mAdulana#nimna_Sakwi_mAdulana#noun#3#RM
lower_gear	nicalA_giyara#nicalA_giyara#noun#2#RM
lower_quadrant	loara_kvAdreMta#loara_kvAdreMta#noun#2#RM
machine_ringing	yanwra_vAxana#yanwra_vAxana#noun#2#RM
magnetic_bearing	cumbakIya_xiSA_koNa#cumbakIya_xiSA_koNa#noun#2#RM
magnetic_meridian	cumbakIya_Xruva_vqwwa#cumbakIya_Xruva_vqwwa#noun#2#RM
magnetic_residual_loss	cumbakIya_avaSiRTa_hAni#cumbakIya_avaSiRTa_hAni#noun#3#RM
magnetic_screen	cumbakIya_AvaraNa#cumbakIya_AvaraNa#noun#2#RM
magneto_generator	mEganeto_janaretara#mEganeto_janaretara#noun#2#RM
magneto_system	cumbakIya_praNAlI#cumbakIya_praNAlI#noun#2#RM
magneto_telephone	cumbakIya_tolIPona#cumbakIya_tolIPona#noun#2#RM
main_line	muKya_lAina#muKya_lAina#noun#2#RM
manual_ringing	karacala_vAxana#karacala_vAxana#noun#2#RM
manual_telephone_exchange	mEnuala_tolIPona_eksaceMja#mEnuala_tolIPona_eksaceMja#noun#3#RM
manually_operated	haswacAliwa#haswacAliwa#noun#2#RM
marker_light	cinhaka_bawwI#cinhaka_bawwI#noun#2#RM
marking_wave	cinhana_warafga#cinhana_warafga#noun#2#RM
master_oscillator	praXAna_xolaka#praXAna_xolaka#noun#2#RM
mechanical_control	yAnwrika_niyanwraNa#yAnwrika_niyanwraNa#noun#2#RM
mechanical_interlocking_lock	yAnwrika_anwarpASana_wAlA#yAnwrika_anwarpASana_wAlA#noun#3#RM
mechanical_signalling	yAnwrika_siganala#yAnwrika_siganala#noun#2#RM
metallic_circuit	XAwvika_paripaWa#XAwvika_paripaWa#noun#2#RM
miniature_light	laGu_bawwI#laGu_bawwI#noun#2#RM
minimum_deviation	nyUnawama_vicalana#nyUnawama_vicalana#noun#2#RM
misleading_indication	BrAmaka_safkewa#BrAmaka_safkewa#noun#2#RM
mobile_communication	cala_saFcAra#cala_saFcAra#noun#2#RM
modified_lower_quadrant_signal	saMSoXiwa_loara_kvAdreMta_siganala#saMSoXiwa_loara_kvAdreMta_siganala#noun#4#RM
mouth_piece	muKikA#muKikA#noun#2#RM
moveable_diamond_crossing	cala_dAyamaNda_krAsiMga#cala_dAyamaNda_krAsiMga#noun#3#RM
multi_aspect	bahu_safkewI#bahu_safkewI#noun#2#RM
multi_channel	bahu_saraNi#bahu_saraNi#noun#2#RM
multi_frequency	bahu_Avqwwi#bahu_Avqwwi#noun#2#RM
multi_lamp	bahu_bawwI#bahu_bawwI#noun#2#RM
multi_meter	bahu_mApaka#bahu_mApaka#noun#2#RM
multiple_reception	bahu_safgrahaNa#bahu_safgrahaNa#noun#2#RM
multiple_twin_cable	bahu_yugala_kebala#bahu_yugala_kebala#noun#3#RM
multiple_unit	bahu_ekaka#bahu_ekaka#noun#2#RM
mutual_conductance	paraspara_saMvAhiwA#paraspara_saMvAhiwA#noun#2#RM
naked_light	anAvqwwa_bawwI#anAvqwwa_bawwI#noun#2#RM
natural_frequency	svABAvika_Avqwwi#svABAvika_Avqwwi#noun#2#RM
near_end_cross_talk	najaxIkI_sirA_miSriwa_vArwA#najaxIkI_sirA_miSriwa_vArwA#noun#4#RM
network_para_meter	prAcala_wanwra#prAcala_wanwra#noun#3#RM
night_alarm	rAwa_kI_cewAvanI#rAwa_kI_cewAvanI#noun#2#RM
nodal_point	nispanxa_biMxu#nispanxa_biMxu#noun#2#RM
noise_figure	ravAfka#ravAfka#noun#2#RM
noise_suppression	Sora_kA_aXilafGana#Sora_kA_aXilafGana#noun#2#RM
non_fusible	agalanIya#agalanIya#noun#2#RM
non_inductive	gEra_preraka#gEra_preraka#noun#2#RM
non_insulated	saMvAhiwa#saMvAhiwa#noun#2#RM
non_inter_locked_layout	gEra_anwarpASiwa_vinyAsa#gEra_anwarpASiwa_vinyAsa#noun#4#RM
non_isolated_line	apqWakkqwa_lAina#apqWakkqwa_lAina#noun#3#RM
non_linear_distortion	areKika_vikqwi#areKika_vikqwi#noun#3#RM
non_magnetic	acumbakIya#acumbakIya#noun#2#RM
non_polarised_relay	aXruviwa_rile#aXruviwa_rile#noun#3#RM
non_resonant	anunAxahIna#anunAxahIna#noun#2#RM
non_signalled_line	siganala_rahiwa_lAina#siganala_rahiwa_lAina#noun#3#RM
non_synchronous	asamakAlika#asamakAlika#noun#2#RM
normal_and_reverse_indication_lock	sAmAnya_Ora_viparIwa_safkewa_wAlA#sAmAnya_Ora_viparIwa_safkewa_wAlA#noun#5#RM
normal_clear_system	sAmAnya_kliyara_praNAlI#sAmAnya_kliyara_praNAlI#noun#3#RM
normal_contact	sAmAnya_samparka#sAmAnya_samparka#noun#2#RM
normal_danger_system	sAmAnya_KawarA_praNAlI#sAmAnya_KawarA_praNAlI#noun#3#RM
normal_interlocking	sAmAnya_anwarpASana#sAmAnya_anwarpASana#noun#2#RM
normal_lock	sAmAnya_wAlA#sAmAnya_wAlA#noun#2#RM
obstructed_line	avaroXiwa_lAina#avaroXiwa_lAina#noun#2#RM
obstructed_test	avaroXiwa_parIkRaNa#avaroXiwa_parIkRaNa#noun#2#RM
occupation_box	roXaka_petI#roXaka_petI#noun#2#RM
occupation_key	roXaka_cAbI#roXaka_cAbI#noun#2#RM
one_train_system	eka_gAdI_praNAlI#eka_gAdI_praNAlI#noun#3#RM
open_circuit	KulA_paripaWa#KulA_paripaWa#noun#2#RM
open_line	cAlU_lAina#cAlU_lAina#noun#2#RM
open_wire	KulA_wAra#KulA_wAra#noun#2#RM
operation_of_points	kANto_kA_pracAlana#kANto_kA_pracAlana#noun#3#RM
out_put	nirgawa#nirgawa#noun#2#RM
outer_home_signal	bAharI_nikata_siganala#bAharI_nikata_siganala#noun#3#RM
outer_most_home_signal	bAhyawama_nikata_siganala#bAhyawama_nikata_siganala#noun#4#RM
over_energisation	awI_urjAyana#awI_urjAyana#noun#2#RM
over_head_alignment	UparI_saMreKaNa#UparI_saMreKaNa#noun#3#RM
over_lapping	awivyApI#awivyApI#noun#2#RM
over_plugging	ovara_plagiMga#ovara_plagiMga#noun#2#RM
over_run	awicAlana#awicAlana#noun#2#RM
over_shoot	awilafGana#awilafGana#noun#2#RM
over_turn	ulata_jAnA#ulata_jAnA#noun#2#RM
overhead_equipment	UparI_upaskara#UparI_upaskara#noun#2#RM
overhead_line	UparI_lAina#UparI_lAina#noun#2#RM
overhead_protection	UparI_saMrakRaNa#UparI_saMrakRaNa#noun#2#RM
p.b.x._final_selector	nijI_SAKA_keMxra_anwima_saMvaraka#nijI_SAKA_keMxra_anwima_saMvaraka#noun#3#RM
pad_lock	wAlA#wAlA#noun#2#RM
paging_and_talk_back_system	KojI_Ora_parivArwA_praNAlI#KojI_Ora_parivArwA_praNAlI#noun#5#RM
paging_loud_speaker	KojI_Xvani_viswAraka#KojI_Xvani_viswAraka#noun#3#RM
parabolic_reflector	paravalayI_parAvarwaka#paravalayI_parAvarwaka#noun#2#RM
partial_restoring_time	AMSika_yaWA_sWApana_samaya#AMSika_yaWA_sWApana_samaya#noun#3#RM
peak_period	vyaswawama_kAla#vyaswawama_kAla#noun#2#RM
periodical_overhaul	AvaXika_ovarahoYla#AvaXika_ovarahoYla#noun#2#RM
periodical_testing	AvaXika_parIkRaNa#AvaXika_parIkRaNa#noun#2#RM
permanent_speed_restriction	sWAyI_gawi_prawibanXa#sWAyI_gawi_prawibanXa#noun#3#RM
permanent_way	rela_paWa#rela_paWa#noun#2#RM
permanent_way_and_works	rela_paWa_va_nirmANa_kArya#rela_paWa_va_nirmANa_kArya#noun#4#RM
permissible_distance	anumawa_xUrI#anumawa_xUrI#noun#2#RM
permissive_signal	anumawi_siganala#anumawi_siganala#noun#2#RM
phantom_indication	BrAmaka_safkewa#BrAmaka_safkewa#noun#2#RM
phase_equaliser	kalA_samakArI#kalA_samakArI#noun#2#RM
phase_velocity	kalA_vega#kalA_vega#noun#2#RM
photo_electric_emission	prakASa_vixyuwa_uwsarjana#prakASa_vixyuwa_uwsarjana#noun#3#RM
pick_up_apparatus	pika-apa_upakaraNa#pika-apa_upakaraNa#noun#3#RM
pick_up_coil	pika-apa_kuNdalI#pika-apa_kuNdalI#noun#3#RM
pick_up_contact	pika-apa_samparka#pika-apa_samparka#noun#3#RM
pick_up_voltage	pika-apa_voltawA#pika-apa_voltawA#noun#3#RM
pilot_guard_system	pAyalata_gArda_paxXawi#pAyalata_gArda_paxXawi#noun#3#RM
pilot_signal	pAyalata_siganala#pAyalata_siganala#noun#2#RM
pinion_lever	piniyana_lIvara#piniyana_lIvara#noun#2#RM
piston_ring	pistana_kiMraga#pistana_kiMraga#noun#2#RM
plane_of_polarisation	XruvaNa_wala#XruvaNa_wala#noun#3#RM
plate_foundation	AXAra_pattI#AXAra_pattI#noun#2#RM
platform_train_indicator	plEtaPArma_gAdI_safkewaka#plEtaPArma_gAdI_safkewaka#noun#3#RM
play_back	prawi_SravaNa#prawi_SravaNa#noun#2#RM
plug_assembly	plaga_samuccaya#plaga_samuccaya#noun#2#RM
plug_clamping	plaga_banXeja#plaga_banXeja#noun#2#RM
plug_in_type	plagavAlI#plagavAlI#noun#3#RM
plug_isolating	viyojaka_plaga#viyojaka_plaga#noun#2#RM
plunger_type_facing_point_lock	plaFjaranumA_sammuKa_kANtA_wAlA#plaFjaranumA_sammuKa_kANtA_wAlA#noun#5#RM
point_adjusting_screw	kANtA_samAyojaka_peMca#kANtA_samAyojaka_peMca#noun#3#RM
point_and_trap_indicator	kANtA_Ora_trEpa_safkewaka#kANtA_Ora_trEpa_safkewaka#noun#4#RM
point_clamp	kANtA_SikaFjA#kANtA_SikaFjA#noun#2#RM
point_clip	kANtA_klipa#kANtA_klipa#noun#2#RM
point_indicator_,_electrical	vixyuwa_kANtA_safkewaka#vixyuwa_kANtA_safkewaka#noun#4#RM
point_indicator_,_target_type	akRanumA_kANtA_safkewaka#akRanumA_kANtA_safkewaka#noun#5#RM
point_indicator_directional_type	xiSAboXI_kANtA_safkewaka#xiSAboXI_kANtA_safkewaka#noun#4#RM
point_indicatormechanical	yAnwrika_kAtA_safkewaka#yAnwrika_kAtA_safkewaka#noun#2#RM
point_lock_lever	kANtA_wAlA_lIvara#kANtA_wAlA_lIvara#noun#3#RM
point_lockground_track	BU_paWa_kANtA_pASa#BU_paWa_kANtA_pASa#noun#3#RM
point_machine	pAiMta_maSIna#pAiMta_maSIna#noun#2#RM
point_motion_wheel	kANtA_gawi_pahiyA#kANtA_gawi_pahiyA#noun#3#RM
point_motor	pAiMta_motara#pAiMta_motara#noun#2#RM
point_motor_high_voltage	pAiMta_motara_ucca_voltawA#pAiMta_motara_ucca_voltawA#noun#4#RM
point_rodding	kANtA_Cada#kANtA_Cada#noun#2#RM
point_slide	kANtA_slAida#kANtA_slAida#noun#2#RM
polar_diagram	XruvIya_AreKa#XruvIya_AreKa#noun#2#RM
polarised_relay	Xruviwa_rile#Xruviwa_rile#noun#2#RM
pole_of_polarisation	XruvIkaraNa_kA_Xruva#XruvIkaraNa_kA_Xruva#noun#3#RM
poly_carbonate_lenses	pAlI_kArboneta_lensa#pAlI_kArboneta_lensa#noun#3#RM
polyphase_type_relay	bahukalIya_prakAra_kA_rile#bahukalIya_prakAra_kA_rile#noun#3#RM
portable_control_phone	suvAhya_niyanwraNa_Pona#suvAhya_niyanwraNa_Pona#noun#3#RM
portable_phone	suvAhya_Pona#suvAhya_Pona#noun#2#RM
power_block	vixyuwa_bloYka#vixyuwa_bloYka#noun#2#RM
power_frame	vixyuwa_Prema#vixyuwa_Prema#noun#2#RM
power_handling_capacity	vixyuwa_saFcAlana_kRamawA#vixyuwa_saFcAlana_kRamawA#noun#3#RM
power_room	vixyuwa_kakRa#vixyuwa_kakRa#noun#2#RM
power_signalling_laboratory	vixyuwa_siganala_prayogaSAlA#vixyuwa_siganala_prayogaSAlA#noun#3#RM
power_source	vixyuwa_Srowa#vixyuwa_Srowa#noun#2#RM
power_worked_signal	vixyuwa_cAliwa_siganala#vixyuwa_cAliwa_siganala#noun#3#RM
pre_amplifier	pUrva_pravarXaka#pUrva_pravarXaka#noun#2#RM
prescribed_code	nirXAriwa_kUta#nirXAriwa_kUta#noun#2#RM
private_automatic_branch_exchange	nijI_svacala_SAKA_telIPona_keMxra#nijI_svacala_SAKA_telIPona_keMxra#noun#4#RM
private_automatic_exchange	nijI_svacala_telIPona_keMxra#nijI_svacala_telIPona_keMxra#noun#3#RM
private_exchange	nijI_telIPona_keMxra#nijI_telIPona_keMxra#noun#2#RM
private_manual_branch_exchange	nijI_haswacala_SAKA_telIPona_keMxra#nijI_haswacala_SAKA_telIPona_keMxra#noun#4#RM
private_manual_exchange	nijI_haswacala_telIPona_keMxra#nijI_haswacala_telIPona_keMxra#noun#3#RM
private_number	prAiveta_nambara#prAiveta_nambara#noun#2#RM
private_wire	prAiveta_vAyara#prAiveta_vAyara#noun#2#RM
prolonged_ringing	lambI_GaNtI#lambI_GaNtI#noun#2#RM
propagation_coefficient	saFcaraNa_guNAfka#saFcaraNa_guNAfka#noun#2#RM
proper_running_line	sahI_paricAlana_lAina#sahI_paricAlana_lAina#noun#3#RM
protective_device	bacAva_sAXana#bacAva_sAXana#noun#2#RM
protector_strip	rakRaka_pattI#rakRaka_pattI#noun#2#RM
proximity_effect	sAniXya_praBAva#sAniXya_praBAva#noun#2#RM
psophometric_voltage	soPomItrI_voltawA#soPomItrI_voltawA#noun#2#RM
public_address_equipment	jana_samboXana_upaskara#jana_samboXana_upaskara#noun#3#RM
public_address_system	jana_samboXana_praNAlI#jana_samboXana_praNAlI#noun#3#RM
pull-pull_mechanism	pula_pula_mEkAnijma#pula_pula_mEkAnijma#noun#2#RM
pull_chart	pula_cArta#pula_cArta#noun#2#RM
pull_sheet	pula_SIta#pula_SIta#noun#2#RM
pulsating_current	spanxI_XArA#spanxI_XArA#noun#2#RM
pulse_modulated_wave	nAdI_spanxiwa_warafga#nAdI_spanxiwa_warafga#noun#3#RM
push_button	xAba_batana#xAba_batana#noun#2#RM
push_button_telephone	xAba_batana_telIPona#xAba_batana_telIPona#noun#3#RM
q_factor	kyU_wawva#kyU_wawva#noun#2#RM
q_meter	kyU_mApaka#kyU_mApaka#noun#2#RM
q_uadrant	kvAdreMta#kvAdreMta#noun#2#RM
radiation_efficiency	vikiraNa_xakRawA#vikiraNa_xakRawA#noun#2#RM
radio_broadcasting	rediyo_prasAraNa#rediyo_prasAraNa#noun#2#RM
radio_communication	rediyo_saFcAra#rediyo_saFcAra#noun#2#RM
radio_frequency	rediyo_Avqwwi#rediyo_Avqwwi#noun#2#RM
radio_link	rediyo_kadI#rediyo_kadI#noun#2#RM
radio_location	rediyo_sWiwi#rediyo_sWiwi#noun#2#RM
radio_receiver	rediyo_safgrAhaka#rediyo_safgrAhaka#noun#2#RM
radio_station	rediyo_steSana#rediyo_steSana#noun#2#RM
radio_telegraphy	rediyo_wAra_vixyA#rediyo_wAra_vixyA#noun#2#RM
radio_telephony	rediyo_telIPonI#rediyo_telIPonI#noun#2#RM
rail_clip	rela_klipa#rela_klipa#noun#2#RM
rail_contact	rela_samparka#rela_samparka#noun#2#RM
rail_net	rela_neta#rela_neta#noun#2#RM
rampant_cover	DAla_Dakkana#DAla_Dakkana#noun#2#RM
rated_voltage	nirXAriwa_voltawA#nirXAriwa_voltawA#noun#2#RM
reactance_transformer	prawikAryawA_trAMsaPArmara#prawikAryawA_trAMsaPArmara#noun#2#RM
reactance_voltage	prawikAryawA_voltawA#prawikAryawA_voltawA#noun#2#RM
record_circuit	aBileKa_paripaWa#aBileKa_paripaWa#noun#2#RM
rectifier_bridge	pariSoXaka_brija#pariSoXaka_brija#noun#2#RM
rectifier_selenium	pariSoXaka_silIniyama#pariSoXaka_silIniyama#noun#2#RM
reflection_loss_or_gain	parivarwana_lABa_yA_hAni#parivarwana_lABa_yA_hAni#noun#4#RM
relay_auto_to_auto_set	svacala_se_svacala_prasAraNa#svacala_se_svacala_prasAraNa#noun#5#RM
relay_coil	rile_kAyala#rile_kAyala#noun#2#RM
relay_set	rile_seta#rile_seta#noun#2#RM
relay_spring	rile_kviMspraga#rile_kviMspraga#noun#2#RM
release_number	nirmukwi_nambara#nirmukwi_nambara#noun#2#RM
release_wire	nirmukwi_wAra#nirmukwi_wAra#noun#2#RM
remote_control	xUravarwI_niyanwraNa#xUravarwI_niyanwraNa#noun#2#RM
remote_control_equipment	xUravarwI_niyanwraNa_upaskara#xUravarwI_niyanwraNa_upaskara#noun#3#RM
repeal_and_saving	nirasana_va_vyAvqwwi#nirasana_va_vyAvqwwi#noun#3#RM
repeat_indication	punarAvqwwa_safkewa#punarAvqwwa_safkewa#noun#2#RM
repeated_circuit	punarAvqwwa_paripaWa#punarAvqwwa_paripaWa#noun#2#RM
repeater_shunt_signal	punarAvarwaka_SaNta_siganala#punarAvarwaka_SaNta_siganala#noun#3#RM
repeating_coil	punarAvarwana_kuNdalI#punarAvarwana_kuNdalI#noun#2#RM
repeating_signal	punarAvarwana_siganala#punarAvarwana_siganala#noun#2#RM
replacer_signal	prawisWApayiwA_siganala#prawisWApayiwA_siganala#noun#2#RM
resetting_lever	punaHsetiMga_lIvara#punaHsetiMga_lIvara#noun#2#RM
residual_magnetism	avaSeRa_cumbakawva#avaSeRa_cumbakawva#noun#2#RM
resistance_unit	prawiroXa_ikAI#prawiroXa_ikAI#noun#2#RM
resistance_unit_variable	prawiroXa_ikAI_parivarwI#prawiroXa_ikAI_parivarwI#noun#3#RM
resistor_variable	prawiroXaka_parivarwI#prawiroXaka_parivarwI#noun#2#RM
restoring_armature	yaWAsWApana_Armecara#yaWAsWApana_Armecara#noun#2#RM
retardation_coil	manxana_kuNdalI#manxana_kuNdalI#noun#2#RM
return_current	prawigAmI_XArA#prawigAmI_XArA#noun#2#RM
return_current_coefficient	prawigAmI_XArA_guNAfka#prawigAmI_XArA_guNAfka#noun#3#RM
return_loss	prawigAmI_hAni#prawigAmI_hAni#noun#2#RM
reverse_interlocking	prawivarwI_anwarpASana#prawivarwI_anwarpASana#noun#2#RM
reversible_working	prawivarwIya_kAryacAlana#prawivarwIya_kAryacAlana#noun#2#RM
reverting_call	prawyAvarwI_kAla#prawyAvarwI_kAla#noun#2#RM
right_hand_quadrant	xAyAM_bAjU_kvAdreta#xAyAM_bAjU_kvAdreta#noun#3#RM
rim_lock_type	wAlA_rima#wAlA_rima#noun#3#RM
ring_seal	kiMraga_sIla#kiMraga_sIla#noun#2#RM
ring_wire	valaya_wAra#valaya_wAra#noun#2#RM
ringing_tone	Ganana_svara#Ganana_svara#noun#2#RM
rocker_arm	xolaka_BujA#xolaka_BujA#noun#2#RM
rocking_shaft	xolana_XurA#xolana_XurA#noun#2#RM
rod_alignment	Cada_saMreKaNa#Cada_saMreKaNa#noun#2#RM
rod_catch_handle	mUTa_Cada#mUTa_Cada#noun#3#RM
rod_insulation	Cada_visaMvAhana#Cada_visaMvAhana#noun#2#RM
rod_roller	Cada_rolara#Cada_rolara#noun#2#RM
rod_run	Cada_reKA#Cada_reKA#noun#2#RM
rotary_detector	GUrNI_sUcaka#GUrNI_sUcaka#noun#2#RM
rotary_switch	GUrNI_svica#GUrNI_svica#noun#2#RM
route_diagram	mArga_ciwra#mArga_ciwra#noun#2#RM
route_direction	mArga_xiSA#mArga_xiSA#noun#2#RM
route_electrical_locking	vixyuwa_mArga_pASana#vixyuwa_mArga_pASana#noun#3#RM
route_indicator	mArga_sUcaka#mArga_sUcaka#noun#2#RM
route_locking	mArga_pASana#mArga_pASana#noun#2#RM
route_locking_sectional_release	sekSana_kI_mArga_pASana_nirmukwi#sekSana_kI_mArga_pASana_nirmukwi#noun#4#RM
route_release	mArga_nirmukwi#mArga_nirmukwi#noun#2#RM
route_signal_system	mArga_siganala_praNAlI#mArga_siganala_praNAlI#noun#3#RM
routing_signal	mArga_sUcaka_siganala#mArga_sUcaka_siganala#noun#2#RM
rubber_sheathed_cable	rabada_AcCAxiwa_kebala#rabada_AcCAxiwa_kebala#noun#3#RM
run_through_train	sIXI_jAne_vAlI_gAdI#sIXI_jAne_vAlI_gAdI#noun#3#RM
running_line	cAlU_lAina#cAlU_lAina#noun#2#RM
safe_custody	surakRiwa_aBirakRA#surakRiwa_aBirakRA#noun#2#RM
safe_running	surakRiwa_cAlana#surakRiwa_cAlana#noun#2#RM
safety_certificate	saMrakRA_pramANa_pawra#saMrakRA_pramANa_pawra#noun#2#RM
safety_rules	saMrakRA_niyama#saMrakRA_niyama#noun#2#RM
sand_hump	rewa_kUbada#rewa_kUbada#noun#2#RM
satellite_communication	upagraha_saFcAra#upagraha_saFcAra#noun#2#RM
saturation_current	sanwqpwa_XArA#sanwqpwa_XArA#noun#2#RM
schottkay_effect	SAtakI_praBAva#SAtakI_praBAva#noun#2#RM
screw_armature	Armecara_peMca#Armecara_peMca#noun#2#RM
screw_buffer	baPara_peMca#baPara_peMca#noun#2#RM
screw_point_adjusting	kANtA_samaFjaka_peMca#kANtA_samaFjaka_peMca#noun#3#RM
sealing_facility	sIlabanxI_suviXA#sIlabanxI_suviXA#noun#2#RM
sealing_oil	sIlabanxI_wela#sIlabanxI_wela#noun#2#RM
search_coil	SoXa_kuNdalI#SoXa_kuNdalI#noun#2#RM
secondary_cell	saFcAyaka_sela#saFcAyaka_sela#noun#2#RM
secondary_emission	gONa_uwsarjana#gONa_uwsarjana#noun#2#RM
seizing_signal	sIjiMga_siganala#sIjiMga_siganala#noun#2#RM
selective_ringing	cayanAwmaka_Ganana#cayanAwmaka_Ganana#noun#2#RM
selector_coil	saMvaraka_kuNdalI#saMvaraka_kuNdalI#noun#2#RM
selector_hunter	saMvaraka_KojI#saMvaraka_KojI#noun#2#RM
self_capacitance	svayaM_XAriwA#svayaM_XAriwA#noun#2#RM
self_inductance	svaprerakawA#svaprerakawA#noun#2#RM
self_propelled	svapraNoxiwa#svapraNoxiwa#noun#2#RM
semaphore_arm	simAPora_BujA#simAPora_BujA#noun#2#RM
semaphore_signal_quadrant	simAPora_siganala_kvAdreMta#simAPora_siganala_kvAdreMta#noun#3#RM
semaphore_signal_spectacle	simAPora_siganala_spektekala#simAPora_siganala_spektekala#noun#3#RM
semaphore_spindle_bearing	simAPora_kviMspadala_beyakiMraga#simAPora_kviMspadala_beyakiMraga#noun#3#RM
semi_automatic	axXaRti_svacala#axXaRti_svacala#noun#2#RM
semi_automatic_signal	arXa_svacala_siganala#arXa_svacala_siganala#noun#3#RM
sequential_scanning	anukramika_aMSekRaNa#anukramika_aMSekRaNa#noun#2#RM
service_band	sevA_pattI#sevA_pattI#noun#2#RM
set_noise	seta_kI_Xvani#seta_kI_Xvani#noun#2#RM
shaft_cap	SAPta_kEpa#SAPta_kEpa#noun#2#RM
shaft_quadrant	SAPta_kvAdreMta#SAPta_kvAdreMta#noun#2#RM
shaft_rocking	SAPta_rAkiMga#SAPta_rAkiMga#noun#2#RM
shock_absorber	XakkA_roXI#XakkA_roXI#noun#2#RM
shock_proof	XakkA_saha#XakkA_saha#noun#2#RM
short_circuit	laGu_paripaWa#laGu_paripaWa#noun#2#RM
short_dead_end_siding	laGu_banxa_paripaWa#laGu_banxa_paripaWa#noun#4#RM
shot_effect	SAta_praBAva#SAta_praBAva#noun#2#RM
shunt_resistance	SaNta_prawiroXa#SaNta_prawiroXa#noun#2#RM
shunt_signal	SaNta_siganala#SaNta_siganala#noun#2#RM
shunt_train	SaNta_gAdI#SaNta_gAdI#noun#2#RM
shunting_limit_board	SaNtiMga_sImA_borda#SaNtiMga_sImA_borda#noun#3#RM
shunting_neck	SaNtiMga_neka#SaNtiMga_neka#noun#2#RM
side_band	pArSva_pattI#pArSva_pattI#noun#2#RM
side_circuit	pArSva_paripaWa#pArSva_paripaWa#noun#2#RM
side_frequency	pArSva_Avqwwi#pArSva_Avqwwi#noun#2#RM
side_light	pArSva_bawwI#pArSva_bawwI#noun#2#RM
side_plate	pArSva_pleta#pArSva_pleta#noun#2#RM
side_tone	pArSva_svaraka#pArSva_svaraka#noun#2#RM
sighting_board	xqSyawA_patala#xqSyawA_patala#noun#2#RM
signal_(_fixed_)	siganala_(sWAvara)#siganala_(sWAvara)#noun#3#RM
signal_alignment_device	siganala_saMreKaNa_upakaraNa#siganala_saMreKaNa_upakaraNa#noun#3#RM
signal_arm	siganala_BujA#siganala_BujA#noun#2#RM
signal_base	siganala_besa#siganala_besa#noun#2#RM
signal_circuit	siganala_paripaWa#siganala_paripaWa#noun#2#RM
signal_colour_light	rafgIna_bawwI_siganala#rafgIna_bawwI_siganala#noun#3#RM
signal_doll	dAla_siganala#dAla_siganala#noun#2#RM
signal_dwarf	bOnA_siganala#bOnA_siganala#noun#2#RM
signal_generator	siganala_janiwra#siganala_janiwra#noun#2#RM
signal_in_advance	agrima_siganala#agrima_siganala#noun#3#RM
signal_in_rear	piCalA_siganala#piCalA_siganala#noun#3#RM
signal_machine	siganala_maSIna#siganala_maSIna#noun#2#RM
signal_motor	siganala_motara#siganala_motara#noun#2#RM
signal_multi_aspect	bahu_safkewI_siganala#bahu_safkewI_siganala#noun#3#RM
signal_not_in_use	aprayuwka_siganala#aprayuwka_siganala#noun#4#RM
signal_position	siganala_kI_sWiwi#siganala_kI_sWiwi#noun#2#RM
signal_post_telephone	siganala_tolIPona_KamBA#siganala_tolIPona_KamBA#noun#3#RM
signal_rail_track_circuit	siganala_rela_paripaWa#siganala_rela_paripaWa#noun#4#RM
signal_search_light	sarcalAita#sarcalAita#noun#3#RM
signal_sighting_deviceperiscope_)	siganala_xqSyawA_sAXana_(periskopa)#siganala_xqSyawA_sAXana_(periskopa)#noun#3#RM
signal_unit	siganala_ikAI#siganala_ikAI#noun#2#RM
signal_velocity	siganala_vega#siganala_vega#noun#2#RM
signal_wheel_base	siganala_pahiyA_AXAra#siganala_pahiyA_AXAra#noun#3#RM
simplex_operation	ekaxiSa_pracAlana#ekaxiSa_pracAlana#noun#2#RM
singing_oscillation	gAyaka_xolaka#gAyaka_xolaka#noun#2#RM
singing_point	gAyaka_biMxu#gAyaka_biMxu#noun#2#RM
singing_suppressor	gAyaka_xamana#gAyaka_xamana#noun#2#RM
single_current	ikaharI_XArA#ikaharI_XArA#noun#2#RM
single_line	ikaharI_lAina#ikaharI_lAina#noun#2#RM
single_line_instrument	ikaharI_lAina_upakaraNa#ikaharI_lAina_upakaraNa#noun#3#RM
single_line_token_instrument	ikaharI_lAina_tokana_upakaraNa#ikaharI_lAina_tokana_upakaraNa#noun#4#RM
single_phase	ikaharI_Peja#ikaharI_Peja#noun#2#RM
single_side_band_transmission	ikaharI_pArSva_bEMda_prasAra#ikaharI_pArSva_bEMda_prasAra#noun#4#RM
single_stroke_bell	ikaharI_cAla_GaNtI#ikaharI_cAla_GaNtI#noun#3#RM
skin_effect	wvAcika_praBAva#wvAcika_praBAva#noun#2#RM
skip_zone	lafGana_kRewra#lafGana_kRewra#noun#2#RM
sky_wave	AkASa_warafga#AkASa_warafga#noun#2#RM
sleeve_control_circuit	slIva_niyanwraNa_paripaWa#slIva_niyanwraNa_paripaWa#noun#3#RM
sleeve_wire	slIva_wAra#slIva_wAra#noun#2#RM
slip_siding	slipa_sAidiMga#slipa_sAidiMga#noun#2#RM
slot_indication	KAFcA_safkewa#KAFcA_safkewa#noun#2#RM
slot_lever	KAFcA_lIvara#KAFcA_lIvara#noun#2#RM
slotted_signal	JirIxAra_siganala#JirIxAra_siganala#noun#2#RM
slow_acting_relay	manxa_rile#manxa_rile#noun#3#RM
smoothing_circuit	sarala_paripaWa#sarala_paripaWa#noun#2#RM
solid_state_interlocking	Tosa_avasWA_anwarapASana#Tosa_avasWA_anwarapASana#noun#3#RM
solid_wire	Tosa_wAra#Tosa_wAra#noun#2#RM
sound_articulation	Xvani_vyakawoccAra#Xvani_vyakawoccAra#noun#2#RM
sounder_bracket	Xvaniwra_banXanI#Xvaniwra_banXanI#noun#2#RM
space_charge	paryAveSa#paryAveSa#noun#2#RM
spacing_wave	anwaraka_warafga#anwaraka_warafga#noun#2#RM
spare_lever	awiriwka_lIvara#awiriwka_lIvara#noun#2#RM
spare_space	awiriwka_sWAna#awiriwka_sWAna#noun#2#RM
spark_plug	sPuliMga_plaga#sPuliMga_plaga#noun#2#RM
spark_quench_circuit	sPuliMga_SAmaka_paripaWa#sPuliMga_SAmaka_paripaWa#noun#3#RM
special_lock	viSeRa_pASa#viSeRa_pASa#noun#2#RM
spectacle_glasses	caSmeM_kA_kAFca#caSmeM_kA_kAFca#noun#2#RM
speed_indication	gawi_safkewa#gawi_safkewa#noun#2#RM
speed_indicator	gawi_safkewaka#gawi_safkewaka#noun#2#RM
speed_limit	gawi_sImA#gawi_sImA#noun#2#RM
spherical_aberration	golIya_vipaWana#golIya_vipaWana#noun#2#RM
split_pin	ciravAM_kIla#ciravAM_kIla#noun#2#RM
split_stretcher_blade	viBawka_wanana_Cada#viBawka_wanana_Cada#noun#3#RM
spring_and_shaft_assembly	kamAnI_va_SAPta_saMyojaka#kamAnI_va_SAPta_saMyojaka#noun#4#RM
spring_catch_handle	mUTa_kamAnI#mUTa_kamAnI#noun#3#RM
spring_helical	sarpila_kamAnI#sarpila_kamAnI#noun#2#RM
spring_point	kamAnIxAra_kANtA#kamAnIxAra_kANtA#noun#2#RM
spring_point_mechanism	kamAnIxAra_yanwrIkaraNa#kamAnIxAra_yanwrIkaraNa#noun#3#RM
spring_washer	kamAnI_vASara#kamAnI_vASara#noun#2#RM
square_law_detection	varga_niyama_paricayana#varga_niyama_paricayana#noun#3#RM
staff_key	daNde_kI_cAbI#daNde_kI_cAbI#noun#2#RM
staff_token	stAPa_tokana#stAPa_tokana#noun#2#RM
stalk_galvanised	jaswexAra_wanA#jaswexAra_wanA#noun#2#RM
stalk_insulator	vixyuwaroXI_wanA#vixyuwaroXI_wanA#noun#2#RM
standard_cable	mAnaka_kebala#mAnaka_kebala#noun#2#RM
standard_dimensions	mAnaka_AyAma#mAnaka_AyAma#noun#2#RM
standard_interlocking	mAnaka_anwarpASana#mAnaka_anwarpASana#noun#2#RM
standard_of_signalling	siganala_praNAlI_mAnaka#siganala_praNAlI_mAnaka#noun#3#RM
star_quad_cable	stAra_kvAda_kebala#stAra_kvAda_kebala#noun#3#RM
starter_signal	prasWAna_siganala/prasWAna_siganala#prasWAna_siganala/prasWAna_siganala#noun#2#RM
station_in_advance	agrima_steSana#agrima_steSana#noun#3#RM
station_in_rear	piCalA_steSana#piCalA_steSana#noun#3#RM
station_limit	steSana_sImA#steSana_sImA#noun#2#RM
station_masters_control	steSana_mAstara_kA_niyanwraNa#steSana_mAstara_kA_niyanwraNa#noun#3#RM
station_masters_key	steSana_mAstara_kI_cAbI#steSana_mAstara_kI_cAbI#noun#3#RM
station_masters_lockup	steSana_mAstara_kA_wAlA_baksa#steSana_mAstara_kA_wAlA_baksa#noun#3#RM
station_masters_slide	steSana_mAstara_kI_slAida#steSana_mAstara_kI_slAida#noun#3#RM
station_section	steSana_sekSana#steSana_sekSana#noun#2#RM
station_stamp	steSana_mohara#steSana_mohara#noun#2#RM
station_working_rule	steSana_saFcAlana_niyama#steSana_saFcAlana_niyama#noun#3#RM
stay_rod	teka_Cada#teka_Cada#noun#2#RM
steel_plate	ispAwI_pleta#ispAwI_pleta#noun#2#RM
steel_sleeper	ispAwI_slIpara#ispAwI_slIpara#noun#2#RM
step_by_step_automatic_system	kramika_svacala_paxXawi#kramika_svacala_paxXawi#noun#5#RM
step_down_transformer	apacAyI_trAMsaPArmara#apacAyI_trAMsaPArmara#noun#3#RM
step_up_transformer	uccAyI_trAMsaPArmara#uccAyI_trAMsaPArmara#noun#3#RM
stick_circuit	stika_paripaWa#stika_paripaWa#noun#2#RM
stop_board	roka_borda/roka_borda#roka_borda/roka_borda#noun#2#RM
stop_dead	ekaxama_rukanA#ekaxama_rukanA#noun#2#RM
stop_indication	roka_safkewaka#roka_safkewaka#noun#2#RM
stop_lock_bar	lAka_bAra_roka#lAka_bAra_roka#noun#3#RM
stop_signal	roka_siganala#roka_siganala#noun#2#RM
strand_wire	valayaka_wAra#valayaka_wAra#noun#2#RM
strip_mounted_set	AruDa_pattI_seta#AruDa_pattI_seta#noun#3#RM
sub_audio_frequency	apa_Sravya_Avqwwi#apa_Sravya_Avqwwi#noun#3#RM
sub_clause	upa_KaNda/upaXArA#upa_KaNda/upaXArA#noun#2#RM
sub_rule	upa_niyama#upa_niyama#noun#2#RM
sub_sectioning_post	upa_sekSaniMga_posta#upa_sekSaniMga_posta#noun#3#RM
subsidiary_rule	sahAyaka_niyama#sahAyaka_niyama#noun#2#RM
subsidiary_signal	sahAyaka_siganala/sahAyaka_siganala#sahAyaka_siganala/sahAyaka_siganala#noun#2#RM
super_audio_frequency	awi_Sravya_Avqwwi#awi_Sravya_Avqwwi#noun#3#RM
super_imposed	aXiropiwa#aXiropiwa#noun#2#RM
super_posed_circuit	aXyAropa_paripaWa#aXyAropa_paripaWa#noun#3#RM
supersonic_frequency	parAXvAnika_Avqwwi#parAXvAnika_Avqwwi#noun#2#RM
support_quadrant	AXAra_kvAdreMta#AXAra_kvAdreMta#noun#2#RM
suppression_grid	niroXI_grida#niroXI_grida#noun#2#RM
surface_leakage	sawahI_SrAva#sawahI_SrAva#noun#2#RM
switch_board	svica_borda#svica_borda#noun#2#RM
switch_board_section	svica_borda_sekSana#svica_borda_sekSana#noun#3#RM
switch_operating_mechanism	svica_paricAlana_yanwrIkaraNa#svica_paricAlana_yanwrIkaraNa#noun#3#RM
switch_rail	svica_patarI#svica_patarI#noun#2#RM
switching_in	cAlU_karanA#cAlU_karanA#noun#2#RM
switching_out	banxa_karanA#banxa_karanA#noun#2#RM
symetrical_deflection	samamiwa_vikRepa#samamiwa_vikRepa#noun#2#RM
synchronous_vibrator	wulyakAlI_kampiwra#wulyakAlI_kampiwra#noun#2#RM
system_of_speech_communication	samBARaNa_saFcAra_praNAlI#samBARaNa_saFcAra_praNAlI#noun#4#RM
system_of_working	saFcAlana_paxXawi#saFcAlana_paxXawi#noun#3#RM
tablet_check	wAravilamba_jAFca#wAravilamba_jAFca#noun#2#RM
tag_block	tEga_bloYka#tEga_bloYka#noun#2#RM
tail_arm	piCalI_BujA#piCalI_BujA#noun#2#RM
tail_board	piCalA_borda#piCalA_borda#noun#2#RM
tail_lamp	pICalI_bawwI#pICalI_bawwI#noun#2#RM
talk_back_amplifier	parivArwA_pravarXaka#parivArwA_pravarXaka#noun#3#RM
tape_recorder	tepa_rikArdara#tepa_rikArdara#noun#2#RM
telecommunication_laboratory	xUrasaFcAra_prayogaSAlA#xUrasaFcAra_prayogaSAlA#noun#2#RM
telephone_amplifier	telIPona_pravarXaka#telIPona_pravarXaka#noun#2#RM
telephone_auto	svacala_telIPona#svacala_telIPona#noun#2#RM
telephone_control	niyanwraNa_telIPona#niyanwraNa_telIPona#noun#2#RM
telephone_magneto	cumbakIya_telIPona#cumbakIya_telIPona#noun#2#RM
telephone_push_button	xAba_batana_telIPona#xAba_batana_telIPona#noun#3#RM
telephone_traffic	yAwAyAwa_telIPona#yAwAyAwa_telIPona#noun#2#RM
telephone_transmitter	telIPona_preRiwra#telIPona_preRiwra#noun#2#RM
television_receiver	xUraxarSana_risIvara#xUraxarSana_risIvara#noun#2#RM
television_transmitter	xUraxarSana_preRiwra#xUraxarSana_preRiwra#noun#2#RM
terminal_block	tarminala_bloYka#tarminala_bloYka#noun#2#RM
terminal_box	tarminala_baksa#tarminala_baksa#noun#2#RM
terminal_of_cable	kebala_tarminala#kebala_tarminala#noun#3#RM
terminal_post	tarminala_KamBA#tarminala_KamBA#noun#2#RM
terminal_station	anwima/tarminala_steSana#anwima/tarminala_steSana#noun#2#RM
terminated_level	samApwi_swara#samApwi_swara#noun#2#RM
terminating_set	samApwi_seta#samApwi_seta#noun#2#RM
termination_indicator	samApwi_safkewaka#samApwi_safkewaka#noun#2#RM
test_jack	parIkRaNa_jEka#parIkRaNa_jEka#noun#2#RM
test_level	parIkRaNa_swara#parIkRaNa_swara#noun#2#RM
testing_guage	jAFca_mApI#jAFca_mApI#noun#2#RM
testing_lamp	jAFca_bawwI#jAFca_bawwI#noun#2#RM
testing_panel	jAFca_patala#jAFca_patala#noun#2#RM
testing_piece	jAFca_mApI#jAFca_mApI#noun#2#RM
testing_position	parIkRaNa_sWiwi#parIkRaNa_sWiwi#noun#2#RM
thermal_agitation_voltage	uRmIya_prakRoBa_voltawA#uRmIya_prakRoBa_voltawA#noun#3#RM
thermionic_emission	wApAyanika_uwsarjana#wApAyanika_uwsarjana#noun#2#RM
thermionic_relay	wApAyanika_rile#wApAyanika_rile#noun#2#RM
three_aspect_colour_light_signal	wIna_safkewI_rafgIna_bawwI_siganala#wIna_safkewI_rafgIna_bawwI_siganala#noun#5#RM
through_line	sIXI_lAina#sIXI_lAina#noun#2#RM
time_base	AXAra_samaya#AXAra_samaya#noun#2#RM
time_based_generator	samaya_AXAriwa_janaretara#samaya_AXAriwa_janaretara#noun#3#RM
time_element_relay	samaya_wawva_rile#samaya_wawva_rile#noun#3#RM
time_pulse_relay	samaya_spanxa_rile#samaya_spanxa_rile#noun#3#RM
time_relay	samaya_rile#samaya_rile#noun#2#RM
tip_wire	wAra_kA_sirA#wAra_kA_sirA#noun#2#RM
token_exchangerreceiver_&_deliver_)	tokana_vinimayiwra_(prApaka_Ora_viwaraka)#tokana_vinimayiwra_(prApaka_Ora_viwaraka)#noun#4#RM
token_instrument_,_auxiliary	tokana_upakaraNa/sahAyaka#tokana_upakaraNa/sahAyaka#noun#4#RM
token_instrument_,_subsidiary	tokana_upakaraNa/upasafgI#tokana_upakaraNa/upasafgI#noun#4#RM
token_less_block_instrument	tokana_rahiwa_bloYka_upakaraNa#tokana_rahiwa_bloYka_upakaraNa#noun#4#RM
token_siding_lock	tokana_sAidiMga_pASana#tokana_sAidiMga_pASana#noun#3#RM
token_station	tokana_steSana#tokana_steSana#noun#2#RM
toll_circuit	paWakara_paripaWa#paWakara_paripaWa#noun#2#RM
toll_position	paWakara_sWiwi#paWakara_sWiwi#noun#2#RM
toll_service	paWakara_sevA#paWakara_sevA#noun#2#RM
tone_control	svara_niyanwraNa#svara_niyanwraNa#noun#2#RM
tone_generator	svara_janiwra#svara_janiwra#noun#2#RM
tongue_rail	jIBa_rela#jIBa_rela#noun#2#RM
tools_and_instrument	OjAra_Ora_upakaraNa#OjAra_Ora_upakaraNa#noun#3#RM
top_roller	UparI_rolara#UparI_rolara#noun#2#RM
total_emission	sampUrNa_uwsarjana#sampUrNa_uwsarjana#noun#2#RM
track_circuit	rela_paripaWa#rela_paripaWa#noun#2#RM
track_circuit_ac	rela_paripaWa/e_sI#rela_paripaWa/e_sI#noun#3#RM
track_circuit_centre_fed	rela_paripaWa_maXya_samBAriwa#rela_paripaWa_maXya_samBAriwa#noun#4#RM
track_circuit_cutting_section	rela_paripaWa_katiMga_sekSana#rela_paripaWa_katiMga_sekSana#noun#4#RM
track_circuit_d_c	rela_paripaWa/dI_sI#rela_paripaWa/dI_sI#noun#4#RM
track_circuit_end_fed	rela_paripaWa_sirA_samBAriwa#rela_paripaWa_sirA_samBAriwa#noun#4#RM
track_indicator	relapaWa_sUcaka#relapaWa_sUcaka#noun#2#RM
track_locking	relapaWa_pASana#relapaWa_pASana#noun#2#RM
track_relay	relapaWa_rile#relapaWa_rile#noun#2#RM
track_tamping	relapaWa_tEkviMmpaga#relapaWa_tEkviMmpaga#noun#2#RM
traction_bond	karRaNa_banXa#karRaNa_banXa#noun#2#RM
traction_installation	karRaNa_saMsWApana#karRaNa_saMsWApana#noun#2#RM
traction_power_controller	karRaNa_Sakwi_niyanwraka#karRaNa_Sakwi_niyanwraka#noun#3#RM
traffic_flow	yAwAyAwa_pravAha#yAwAyAwa_pravAha#noun#2#RM
traffic_meter	yAwAyAwa_mApI#yAwAyAwa_mApI#noun#2#RM
traffic_unit	yAwAyAwa_ikAI#yAwAyAwa_ikAI#noun#2#RM
trail_through	kANtA_Bexana#kANtA_Bexana#noun#2#RM
trailing_direction	anumuKa_xiSA#anumuKa_xiSA#noun#2#RM
train_indication	gAdI_safkewa#gAdI_safkewa#noun#2#RM
train_on_line	lAina_para_gAdI#lAina_para_gAdI#noun#3#RM
train_parting	gAdI_viBAjana#gAdI_viBAjana#noun#2#RM
train_radio	trena_rediyo#trena_rediyo#noun#2#RM
train_register	gAdI_rajistara#gAdI_rajistara#noun#2#RM
train_shunt	gAdI_SaNta#gAdI_SaNta#noun#2#RM
train_signal_register	gAdI_siganala_rajistara#gAdI_siganala_rajistara#noun#3#RM
train_staff_and_ticket_system	gAdI_stAPa_waWA_tikata_praNAlI#gAdI_stAPa_waWA_tikata_praNAlI#noun#5#RM
train_waiting_indicator	gAdI_prawikRA_safkewa#gAdI_prawikRA_safkewa#noun#3#RM
transfer_,_circuit	paripaWa_anwaraNa#paripaWa_anwaraNa#noun#3#RM
transfer_impedence	avabAXA_anwaraNa#avabAXA_anwaraNa#noun#2#RM
transformer_,_air_cool	vAyu_SIwaka_trAMsaPArPamara#vAyu_SIwaka_trAMsaPArPamara#noun#4#RM
transformer_,_water_cool	jala_SIwaka_trAMsaPArPamara#jala_SIwaka_trAMsaPArPamara#noun#4#RM
transit_time	pAraganana_samaya#pAraganana_samaya#noun#2#RM
transmission_loss	saFcAraNa_hAni#saFcAraNa_hAni#noun#2#RM
transposition_of_wire	wAra_kA_pakRAnwara#wAra_kA_pakRAnwara#noun#3#RM
trap_indicator	trEpa_safkewaka#trEpa_safkewaka#noun#2#RM
trap_siding	trEpa_sAidiMga#trEpa_sAidiMga#noun#2#RM
trap_switch	trEpa_svica#trEpa_svica#noun#2#RM
trapezium_distortion	samalamba_vikqwi#samalamba_vikqwi#noun#2#RM
trigger_relay	trigara_rile#trigara_rile#noun#2#RM
triple_pole_lamp	wriXruvIya_bawwI#wriXruvIya_bawwI#noun#3#RM
trouble_shoot	ApAwI_marammawa#ApAwI_marammawa#noun#2#RM
true_bearing	yaWArWa_xikamAna#yaWArWa_xikamAna#noun#2#RM
trunk_circuit	trafka_paripaWa#trafka_paripaWa#noun#2#RM
trunk_exchange	trafka_keMxra#trafka_keMxra#noun#2#RM
trunk_junction_circuit	trafka_jafkSana_paripaWa#trafka_jafkSana_paripaWa#noun#3#RM
trunk_offering_final_selector	trafka_xeya_anwima_saMvaraka#trafka_xeya_anwima_saMvaraka#noun#4#RM
trunk_offering_selector	trafka_xeya_saMvaraka#trafka_xeya_saMvaraka#noun#3#RM
trunk_position	trafka_sWiwi#trafka_sWiwi#noun#2#RM
trunk_record_position	trafka_aBileSa_sWiwi#trafka_aBileSa_sWiwi#noun#3#RM
trunking_diagram	trafkiMga_AreKa#trafkiMga_AreKa#noun#2#RM
tubular_lever	nAlikAkAra_lIvara#nAlikAkAra_lIvara#noun#2#RM
tubular_post	nAlikAkAra_swamBa#nAlikAkAra_swamBa#noun#2#RM
tummy_bar	tammI_bAra#tammI_bAra#noun#2#RM
tuned_circuit	samasvariwa_paripaWa#samasvariwa_paripaWa#noun#2#RM
tuning_fork_oscillator_drive	svariwra_xviBuja_xoRtilaka_preraNa#svariwra_xviBuja_xoRtilaka_preraNa#noun#4#RM
tunnel_alarm	surafga_alArma#surafga_alArma#noun#2#RM
turn_off_time	Samana_kAla#Samana_kAla#noun#3#RM
turn_out	tarna_Auta#tarna_Auta#noun#2#RM
twin_cable	yugala_kebala#yugala_kebala#noun#2#RM
two_aspect_signal	xvisafkewI_siganala#xvisafkewI_siganala#noun#3#RM
two_frequency_signalling	xo_Avqwwi_siganala_vyavasWA#xo_Avqwwi_siganala_vyavasWA#noun#3#RM
two_motion_selector	xo_gawi_saMvaraka#xo_gawi_saMvaraka#noun#3#RM
two_position_signal	xo_sWiwi_siganala#xo_sWiwi_siganala#noun#3#RM
two_way_switch	xo_muKI_svica#xo_muKI_svica#noun#3#RM
two_wire_amplifier	xo_wAra_pravarXaka#xo_wAra_pravarXaka#noun#3#RM
two_wire_circuit	xo_wAra_paripaWa#xo_wAra_paripaWa#noun#3#RM
unit_ditector	ikAI_paricAyaka#ikAI_paricAyaka#noun#2#RM
unrestricted_speed	nirbAXa_gawi#nirbAXa_gawi#noun#2#RM
unworked_warner_signal	sWAvara_cewAvanI_siganala#sWAvara_cewAvanI_siganala#noun#3#RM
upper_quadrant	UparI_kvAdreMta#UparI_kvAdreMta#noun#2#RM
vaccum_tube	nirvAwa_nalI#nirvAwa_nalI#noun#2#RM
vaccum_tube_rectifier	nirvAwa_nalI_pariSoXaka#nirvAwa_nalI_pariSoXaka#noun#3#RM
valve_amplifier	vAlva_pravarXana#vAlva_pravarXana#noun#2#RM
variable_light	parivarwI_bawwI#parivarwI_bawwI#noun#2#RM
velocity_modulation	vega_mAdulana#vega_mAdulana#noun#2#RM
velocity_modulation_valve	vega_mAdulana_vAlva#vega_mAdulana_vAlva#noun#3#RM
vertical_aerial	UXrvAXara_vAyavIya#UXrvAXara_vAyavIya#noun#2#RM
vertical_detent_assembly	UXrvAXara_kuwwA_samuccaya#UXrvAXara_kuwwA_samuccaya#noun#3#RM
vertical_polarised_waves	UXrvAXara_Xruviwa_warafga#UXrvAXara_Xruviwa_warafga#noun#3#RM
vertical_ratchet	UXrvAXara_rEcata#UXrvAXara_rEcata#noun#2#RM
vibration_relay_set	kampana_rile_seta#kampana_rile_seta#noun#3#RM
virtual_cathode	kalpiwa_keWoda#kalpiwa_keWoda#noun#2#RM
visible_obstruction	prawyakRa_avaroXa#prawyakRa_avaroXa#noun#2#RM
visual_indicator	xqSya_sUcaka#xqSya_sUcaka#noun#2#RM
voice_frequency	vArwA_Avqwwi#vArwA_Avqwwi#noun#2#RM
voice_frequency_key_sending	vArwA_Avqwwi_kuFjI_BejanA#vArwA_Avqwwi_kuFjI_BejanA#noun#4#RM
voltage_doubler	voltawA_xugunI#voltawA_xugunI#noun#2#RM
voltage_drop	voltawA_pAwa#voltawA_pAwa#noun#2#RM
voltage_feed_back	voltawA_prawi_samBaraka#voltawA_prawi_samBaraka#noun#3#RM
volume_control	Xanawva_niyanwraNa#Xanawva_niyanwraNa#noun#2#RM
warning_board	cewAvanI_patta#cewAvanI_patta#noun#2#RM
warning_signal	cewAvanI_siganala#cewAvanI_siganala#noun#2#RM
washer_spring	kamAnIxAra_vASara#kamAnIxAra_vASara#noun#2#RM
water_tight	jalaroXI#jalaroXI#noun#2#RM
wave_aerial	vAyavIya_warafga#vAyavIya_warafga#noun#2#RM
wave_guide	warafga_paWikA#warafga_paWikA#noun#2#RM
wave_length	warafga_lambAI#warafga_lambAI#noun#2#RM
wave_length_meter	warafga_lambAI_mApaka#warafga_lambAI_mApaka#noun#3#RM
wave_meter	warafga_mApaka#warafga_mApaka#noun#2#RM
wave_trap	warafga_trEpa#warafga_trEpa#noun#2#RM
wave_velocity	warafga_vega#warafga_vega#noun#2#RM
way_side_station	mArgasWa_CotA_steSana#mArgasWa_CotA_steSana#noun#3#RM
weather_proof	Qwu_saha#Qwu_saha#noun#2#RM
weighing_net_work	BAraNa_jAlI#BAraNa_jAlI#noun#3#RM
wheel_bond	pahiyA_banXa#pahiyA_banXa#noun#2#RM
wheel_draft	pahiyA_drAPta#pahiyA_drAPta#noun#2#RM
wheel_flat	sapAta_pahiyA#sapAta_pahiyA#noun#2#RM
wheel_pedestal	pITI_kA_pahiyA#pITI_kA_pahiyA#noun#2#RM
wicket_level_crossing_gate	upa_samapAra_PAtaka#upa_samapAra_PAtaka#noun#4#RM
winch_signal	viMca_siganala#viMca_siganala#noun#2#RM
wing_nut	pafKI_DibarI#pafKI_DibarI#noun#2#RM
wiper_terminal	sparSaka_KUNtI#sparSaka_KUNtI#noun#2#RM
wire_alignment	wAra_saMreKaNa#wAra_saMreKaNa#noun#2#RM
wire_pulleys	wAra_GiranI#wAra_GiranI#noun#2#RM
wire_rope	wAra_rassA#wAra_rassA#noun#2#RM
wire_run	wAra_paWa#wAra_paWa#noun#2#RM
wire_stripper	wAra_Kolane_vAlA#wAra_Kolane_vAlA#noun#2#RM
wire_thimble_or_eyelet	wAra_WiMbala_yA_surAKa#wAra_WiMbala_yA_surAKa#noun#4#RM
wire_wound	lipatA_huA_wAra#lipatA_huA_wAra#noun#2#RM
working_of_station	steSana_kA_kAryacAlana#steSana_kA_kAryacAlana#noun#3#RM
working_rules	kArya_saFcAlana_niyama#kArya_saFcAlana_niyama#noun#2#RM
working_time_table	kArya_cAlana_samaya_sAraNI#kArya_cAlana_samaya_sAraNI#noun#3#RM
working_warner_signal	cAlU_cewAvanI_siganala#cAlU_cewAvanI_siganala#noun#3#RM
written_circuit	liKiwa_paripaWa#liKiwa_paripaWa#noun#2#RM
yard_diagram	yArda_AreKa#yArda_AreKa#noun#2#RM
yard_plan	yArda_kA_nakSA#yArda_kA_nakSA#noun#2#RM
yard_stick	mApa_xaNda#mApa_xaNda#noun#2#RM
zebra_board	jebrA_patta#jebrA_patta#noun#2#RM
zenner_diode	jEnara_doyoda#jEnara_doyoda#noun#2#RM
zero_level_sensitivity	SUnya_wala_saMvexiwA#SUnya_wala_saMvexiwA#noun#3#RM
zero_loss_circuit	SUnya_paripaWa_lopa#SUnya_paripaWa_lopa#noun#3#RM
zinc_bar	jaswA_Cada#jaswA_Cada#noun#2#RM
