0	0
COMP	kaMte_eVkkuva
GEN	yoVkka
INF	a
PAST	A
PAST_not	ale
#PPART	i_uMdu_A
PPART	A
PRES	wA
#BE	aMdi
#be_	aMdi
BE_PRES	E_A
BE_PRES_not	ale
BE_PAST	gA_e
BE_PAST_not_ing	wU_ale
BE_PAST_not	gA_ale
do_PRES	wA
do_PAST	A
have_PAST	i_veVyyi_A
BE_FUT_not_0	gA_0_a_ale
PROG	wunnA
SUPER	anniti_kaMte+0
MORE	eVkkuva
am_not_en	a_bada_ale
am_not	a
am_en	a_badu_wA
are	wA
are_en	a_badu_wA
are_not	a_ale
are_en_not	a_badu_ale
#can_0	a_gala
can_0	a_galugu_wA
can_not_0	a_gala_a
cannot_0	a_gala_a
can't_0	a_gala_a
can_be_en	a_vaccunu
can_be_en_not	a_gUdaxu
could_PRES	a_galugu_A
could_0	a_galugu_A
could_not_0	a_leka_po_A
couldn't_0	a_leka_po_A
could_be_en	a_galugu_A
could_be_en_not	a_leka_po_A
could_have_been_en	i_uMda_vaccunu
could_have_been_en_not	uMdu_akapo_vaccunu
could_have_en	i_uMda_vaccu
could_have_en	E_0_i_uMda_vaccu
could_have_en_not	i_uMdu_akapo_vaccu
dare_0	a_sAhasiMcu_wA
dare_not_0	a_sAhasiMcu_a
decided_not	a_nirNayiMcu_ale
did_0	A
didn't_0	ale
did_not_0	ale
did_not	ale
did_have_to_0	a_valasina_avasaraM_vaccu_A
did_have_to_0_not	Alsina_avasaraM_vaccu_ale
did_use_to_0_not	a_vaccu_ale
#do_0	wA/wunnA
do_0	wunnA
don't_0	a
#do_not_0	a_vaxxu
do_not_0	a
do_have_to_0	a_navasaraM_A
do_have_to_0_not	a_navasaraM_le
does_0	wA
does_n't_0	a
does_not_0	a
does_have_to_0	a_valasi_uMdu_A
does_have_to_0_not	a_navasaraM_le
ed_0	A
get_en	a_badu_wA
gets_en	a_badu_wA
got_en	a_badiMxi
had_been_ing	wU_uMdu_A
had_not_been_ing	wU_uMdu_adaM_le
had_been_ing_not	wU_uMdu_adaM_le
had_been_en	a_badu_A
had_been_en_not	a_badu_ale
had_en	i_uMdu_A
had_en_not	i_uMdu_ale
had_not	i_uMdu_ale
had_not_0	i_uMdu_ale
had_not_en	i_uMdu_ale
had_to_0	valasivacciMxi
has_been_en	i_uMdu_A
has_been_ing	wU_uMdu_wunnA
has_been_ing_not	wU_uMdu_adaM_lexu
has_en	i_veVyyi_A
has_not_en	i_veVyyi_ale
has_to_0	Ali
have_been_ing	wU_uMdu_wA
have_not_been_ing	wU_uMdu_adaM_le
have_been_en	i_veVyyi_A
have_not_en	i_veVyyi_ale
have_not_been_en	i_veVyyi_ale
has_not_been_en	i_veVyyi_ale
have_en_0	i_veS_A
have_to_0	Ali
have_en	i_veVyyi_A
having_en	ina_warvAwa
ing_0	adaM
ing_not	aka_po_adaMle
is_able_to_0	a_galugu_wA
is_en	a_badu_A
is_not	ale
is_not_en	a_badu_ale
be_ing	wunnA
is_ing	wunnA
are_ing	wunnA
am_ing	wunnA
am_having_ing	adaM_ku_gA_uMdu
is_having_ing	adaM_ki_kaligi_uMdu
was_having_ing	adaM_ki_kaligi_uMdu
were_having_ing	adaM_ki_kaligi_uMdu
are_having_ing	adaM_ki_kaligi_uMdu
are_not_being_0	adaMle
are_not_being_en	wU_uMdu_adaMle
are_not_being_en_0	wU_uMdu_adaMle
am_ing_not	adaM_lexu
is_ing_not	adaM_lexu
was_ing_not	adaM_lexu
am_not_ing	adaM_lexu
are_not_ing	adaM_lexu
is_not_ing	adaM_lexu
was_not_ing	wU_uMdu_adaM_lexu
were_not_ing	wU_uMdu_adaM_lexu
is_not_being_en	a_badu_adaM_lexu
is_not_going_to_0	a_bo_adaM_lexu
let_0	a_nivvu
keep_0	wU_uMdu
kept_0	i_uMdu_A
may_PRES	a_vaccu
may_0	a_vaccu
may_not_0	aka_povaccu
may_have_been_ing	wU_uMdavaccu
may_have_been_ing_not	wU_uMdaka_povaccu
may_be_en	i_uMdu_A
may_have_en	i_uMdavaccu
may_have_en_not	i_uMdaka_povaccu
might_0	a_vaccu
might_not_0	e_avakASaM_lexu
might_be_ing	wU_uMdavaccu
might_be_ing_not	wU_uMdaka_povaccu
might_have_been_ing	wU_uMdi_uMdavaccu
might_have_been_ing_not	wU_uMdi_uMdaka_povaccu
might_have_en	i_uMdavaccu
might_have_en_not	i_uMdaka_povaccu
must_0	Ali
must_0_not	a_gUdaxu
must_not_0	a_gUdaxu
must_be_ing	wU_uMdAli
must_have_been_ing	wU_uMdi_uMdAlI
must_have_been_ing_not	wU_uMdi_uMdaka_povaccu
must_have_en	i_uMdi_uMdAlI
must_have_en_not	i_uMdaka_povAlI
need_not_0	a_navasaraM_lexu
need_to_0	adaM_avasaraM
not_having_en_not	aka_povadaM_valana
not_0	ale
not_to_0	a_vaxxu
not_to_have_en	akapo_wi
want_to_0	a_Ali_anuko
want_to_0_not	a_Ali_anuko_a_
want_to_have_en	i_uMda_valasiMxi
want_to_have_en_not	akuMdA_vuMda_valasiMxi
ought_to_0	a_valasivuMtuMxi
ought_to_0_not	a_rAxu
ought_to_have_en	i_uMda_valasiMxi
ought_to_have_en_not	akuMdA_vuMda_valasiMxi
please_0	xayacesi
shall_0	Ali
shall_not_0	a
shall_not_PRES	a
should_0	Ali
should_not_0	a_gUdu_a
should_be_to_0
should_be_able_to_0	{i/a}_[ko]_galugu_uMdu_Ali
should_be_to_0_not
should_have_been_en	{ku/nu}_i_uMda_valasiMxi
should_have_been_en_not	{ku/nu}_i_uMda_valasiMxi_kAxu
should_have_been_ing	wU_vuMdi_vuMdAli
should_have_been_ing_not	wU_vuMdi_vuMda_gUdaxu
should_have_en	i_vuMdu_a_valasiMxi
should_have_en_not	akuMdA_vuMda_valasiMxi
should_not_have_en	akuMdA_vuMda_valasiMxi
should_not_have_en	akuMdA_vuMdu_a_valasiMxi
would_have_en	i_uMdu_Ali
would_not_have_en	akuMdA_uMdu_Ali
would_0	wA_!
will_have_to_0	a_valasi_uMdu
will_have_to_0_not	a_navasaraM_le
will_be_not	a
will_not_be_ing	wU_uMdu_a_po_a
to_0	adaM_ki
is_to_0	adaM_ki
to_be_en	adaM_ki
be_en	a_badu_A
used_to_0	e_0_ni
was	A
was_en	a_badu_A
was_not_en	a_bada_lexu
was_ing	wunnA
were_ing	wunnA
was_ing_not	e_vANNi_kAxu
were_en	a_baddAru
were_en_not	a_bada_lexu
BE_FUT_0	wA
will_0	wA
will_not_0	a
will_be_en	wA
will_be_en_not	a
will_be_able_not_0	gA_0_a_ale
will_be_ing	wU_uMdu_wA
will_be_ing_not	wU_uMdu_a
will_have_been_0_ing	wU_uMdu_i_uMdavaccu
will_have_been_0_ing	wU_uMdu_i_uMdu_a_vaccu
#will_have_been_ing	wU_uMdu_i_uMdu_wA
will_have_been_ing	i_uMdu_wA
will_not_have_been_ing	i_uMdu_a
shall_0_not	a
shall_be_en	Ali
shall_not_be_en	a_gUdaxu
shall_be_ing	wU_uMdu_wA
shall_be_ing_not	adaM_lexu
shall_have_been_ing	wU_uMdu_i_uMdu_wA
tried_to_0	a_prayawniMcu_A
tried_not	a_prayawniMcu_ale
